Liczba urn, Pierwsza kolizja, Puste urny po n rzutach, Przynajmniej jedna kulka w kazdej urnie, Przynajmiej dwie kulki w kazdej urnie, Roznica
1000,9,363,5949,7821,1872
1000,35,361,7563,11005,3442
1000,51,377,9709,10444,735
1000,55,368,10130,11820,1690
1000,6,380,5884,8411,2527
1000,50,368,10006,11576,1570
1000,28,371,7951,8950,999
1000,25,379,8249,14408,6159
1000,19,362,7662,8994,1332
1000,63,355,7399,10887,3488
1000,34,378,8167,9041,874
1000,17,358,6032,9627,3595
1000,27,367,6604,9347,2743
1000,31,373,10880,14591,3711
1000,77,360,8048,10316,2268
1000,42,381,5841,8677,2836
1000,28,360,7301,11281,3980
1000,41,350,8225,10380,2155
1000,45,370,8649,11369,2720
1000,25,364,7863,9901,2038
1000,77,370,6649,8782,2133
1000,14,371,10560,11430,870
1000,62,382,7342,10263,2921
1000,55,366,7590,7609,19
1000,44,374,6499,7900,1401
1000,46,372,7100,10866,3766
1000,40,356,5201,10058,4857
1000,64,380,7184,9869,2685
1000,57,363,5885,9824,3939
1000,45,386,7807,10040,2233
1000,28,371,5326,10188,4862
1000,66,365,7337,8982,1645
1000,45,366,6575,9739,3164
1000,13,370,7926,11878,3952
1000,41,368,6883,8982,2099
1000,15,360,7598,10588,2990
1000,72,383,6506,9180,2674
1000,36,371,9083,13692,4609
1000,28,365,7157,9578,2421
1000,25,392,7480,8788,1308
1000,40,363,7453,10959,3506
1000,74,366,6715,9523,2808
1000,51,368,8000,12843,4843
1000,25,385,6827,7788,961
1000,44,392,6631,14135,7504
1000,25,363,7016,10401,3385
1000,9,366,7236,9097,1861
1000,24,372,8095,9600,1505
1000,25,355,7390,11720,4330
1000,16,347,10354,13205,2851
2000,31,750,17672,21698,4026
2000,62,729,14882,24081,9199
2000,44,733,18460,22528,4068
2000,101,734,18952,24934,5982
2000,3,725,17480,20976,3496
2000,89,747,17830,20514,2684
2000,63,758,19623,21166,1543
2000,43,740,16267,21493,5226
2000,37,741,18728,21422,2694
2000,62,723,18187,20199,2012
2000,87,736,14690,22448,7758
2000,39,715,16731,17861,1130
2000,53,733,15373,22765,7392
2000,51,737,17985,20134,2149
2000,49,742,15607,20523,4916
2000,33,740,14883,26712,11829
2000,85,714,13181,20584,7403
2000,46,744,17421,20820,3399
2000,66,748,19273,22012,2739
2000,130,737,17777,24880,7103
2000,24,724,19772,23043,3271
2000,42,751,15516,20741,5225
2000,17,704,20370,23648,3278
2000,85,743,15500,18058,2558
2000,29,767,13426,17255,3829
2000,29,756,17427,18836,1409
2000,75,711,16314,16893,579
2000,126,733,13325,20738,7413
2000,87,733,14563,19958,5395
2000,61,754,16497,21441,4944
2000,65,755,15532,18540,3008
2000,22,734,21103,22837,1734
2000,60,724,16320,22837,6517
2000,22,734,17678,22500,4822
2000,34,742,12404,18120,5716
2000,44,732,19981,23400,3419
2000,29,717,16850,20541,3691
2000,113,752,14691,21516,6825
2000,55,746,13670,19085,5415
2000,38,748,13682,21865,8183
2000,24,774,16153,30052,13899
2000,50,749,17114,22308,5194
2000,26,726,20526,20691,165
2000,50,742,16817,17468,651
2000,81,742,22126,24953,2827
2000,29,733,17223,20445,3222
2000,38,751,15577,17869,2292
2000,106,749,16341,23152,6811
2000,23,739,15558,17697,2139
2000,51,735,12838,17393,4555
3000,32,1109,23407,35449,12042
3000,52,1109,27250,29963,2713
3000,47,1088,29718,41792,12074
3000,200,1088,21577,30412,8835
3000,51,1120,27805,32885,5080
3000,42,1104,20344,36475,16131
3000,98,1118,28663,33118,4455
3000,38,1085,27926,33123,5197
3000,116,1108,29251,33206,3955
3000,31,1091,26948,28619,1671
3000,84,1081,22881,29946,7065
3000,43,1082,26550,34666,8116
3000,111,1111,23224,36054,12830
3000,42,1081,27265,42097,14832
3000,29,1103,24230,28861,4631
3000,35,1086,27119,31069,3950
3000,107,1088,23780,33941,10161
3000,69,1113,24942,34429,9487
3000,74,1096,21964,33029,11065
3000,155,1112,27627,30859,3232
3000,96,1110,27900,29179,1279
3000,64,1133,22490,28030,5540
3000,78,1094,22288,28985,6697
3000,110,1108,27488,33219,5731
3000,84,1117,23224,33548,10324
3000,54,1086,20638,36147,15509
3000,77,1105,31428,33475,2047
3000,73,1084,19428,36231,16803
3000,93,1088,22115,31444,9329
3000,67,1085,24420,31427,7007
3000,101,1075,39139,43795,4656
3000,51,1116,30919,41410,10491
3000,97,1119,27114,36006,8892
3000,133,1105,28142,38703,10561
3000,48,1098,24541,40134,15593
3000,82,1116,22987,29255,6268
3000,50,1100,29550,32406,2856
3000,98,1104,21187,30826,9639
3000,166,1119,29065,29664,599
3000,23,1104,26552,36511,9959
3000,34,1108,27487,30825,3338
3000,116,1065,23396,33050,9654
3000,41,1121,26911,30551,3640
3000,52,1125,23593,31202,7609
3000,43,1113,27698,31387,3689
3000,81,1078,26289,31716,5427
3000,34,1093,22207,33412,11205
3000,84,1127,26011,36263,10252
3000,49,1091,28076,38558,10482
3000,101,1109,28277,28660,383
4000,45,1474,55485,67378,11893
4000,124,1451,33614,59352,25738
4000,35,1448,28884,42321,13437
4000,75,1455,33660,40708,7048
4000,66,1474,27253,40792,13539
4000,156,1456,29565,42033,12468
4000,21,1463,42914,50671,7757
4000,81,1462,37816,38066,250
4000,104,1486,36420,44463,8043
4000,55,1490,41251,42871,1620
4000,75,1463,34659,44804,10145
4000,115,1445,31977,51926,19949
4000,128,1443,38802,40939,2137
4000,85,1512,48301,48567,266
4000,110,1473,33270,51730,18460
4000,38,1439,32954,47334,14380
4000,68,1484,34523,54304,19781
4000,56,1499,29721,45657,15936
4000,103,1439,30922,39914,8992
4000,119,1486,29286,37074,7788
4000,63,1466,34959,50855,15896
4000,51,1490,37208,52041,14833
4000,82,1476,44588,49590,5002
4000,40,1485,38321,41852,3531
4000,118,1464,40650,45463,4813
4000,60,1432,33985,48597,14612
4000,130,1465,32066,46341,14275
4000,120,1460,42020,49915,7895
4000,15,1488,32438,40526,8088
4000,61,1473,32294,45504,13210
4000,34,1460,30328,37351,7023
4000,85,1520,33919,42957,9038
4000,104,1468,37289,44804,7515
4000,46,1483,33662,41259,7597
4000,110,1492,33204,46701,13497
4000,73,1475,34437,41815,7378
4000,98,1454,31901,38878,6977
4000,86,1475,30433,51031,20598
4000,44,1462,32266,44231,11965
4000,101,1475,31361,39250,7889
4000,99,1489,32616,49507,16891
4000,93,1516,36912,47235,10323
4000,4,1465,31811,39813,8002
4000,92,1446,33734,47690,13956
4000,109,1459,30866,41016,10150
4000,45,1483,30968,53155,22187
4000,43,1493,35522,58423,22901
4000,77,1483,33851,43894,10043
4000,80,1436,32457,42667,10210
4000,110,1464,34211,45019,10808
5000,225,1892,49103,58989,9886
5000,155,1814,45040,60396,15356
5000,74,1835,41053,55774,14721
5000,70,1865,40242,57065,16823
5000,34,1855,39187,59416,20229
5000,44,1867,45790,67244,21454
5000,86,1854,46932,54391,7459
5000,80,1858,48864,55172,6308
5000,108,1821,47860,55884,8024
5000,55,1818,41715,56380,14665
5000,127,1859,50311,58472,8161
5000,67,1876,43217,60993,17776
5000,39,1837,39300,73558,34258
5000,117,1834,52819,64576,11757
5000,53,1894,61287,71317,10030
5000,123,1817,48900,57919,9019
5000,56,1853,40761,51862,11101
5000,23,1821,50414,56239,5825
5000,39,1837,44504,65697,21193
5000,17,1853,37410,52423,15013
5000,70,1835,43975,57376,13401
5000,28,1853,40192,53446,13254
5000,132,1807,54367,56275,1908
5000,118,1833,38314,52798,14484
5000,91,1825,49861,59550,9689
5000,47,1851,45129,52321,7192
5000,145,1797,46287,61648,15361
5000,135,1840,51536,62178,10642
5000,66,1815,41012,64254,23242
5000,95,1844,40926,58304,17378
5000,211,1847,40286,55239,14953
5000,111,1865,60341,62860,2519
5000,103,1815,39097,58710,19613
5000,83,1867,49167,57280,8113
5000,70,1831,41796,56417,14621
5000,34,1798,43239,56924,13685
5000,10,1830,42470,53292,10822
5000,64,1871,50343,52714,2371
5000,29,1818,42275,56233,13958
5000,90,1828,37066,65273,28207
5000,53,1830,46302,59821,13519
5000,40,1817,49395,51324,1929
5000,135,1797,47025,54521,7496
5000,161,1824,40477,51274,10797
5000,246,1874,41193,55711,14518
5000,117,1857,43237,57709,14472
5000,110,1814,39167,54359,15192
5000,64,1869,50344,51576,1232
5000,209,1850,52520,76959,24439
5000,84,1856,45571,66864,21293
6000,85,2215,53879,59648,5769
6000,54,2224,55042,77401,22359
6000,42,2206,62446,76294,13848
6000,88,2183,53293,64743,11450
6000,134,2254,53609,60090,6481
6000,170,2223,63752,63790,38
6000,175,2180,48013,83172,35159
6000,118,2164,47865,64050,16185
6000,68,2203,67399,70341,2942
6000,77,2223,64021,88129,24108
6000,100,2264,60158,71096,10938
6000,252,2208,59263,69294,10031
6000,112,2174,50116,64455,14339
6000,139,2216,59938,80332,20394
6000,148,2239,50076,69908,19832
6000,158,2180,54768,66121,11353
6000,108,2182,56896,62629,5733
6000,32,2171,52217,65019,12802
6000,105,2212,61970,86880,24910
6000,93,2225,52096,63823,11727
6000,110,2219,54821,67503,12682
6000,40,2180,55583,70482,14899
6000,76,2199,55031,103685,48654
6000,254,2200,52082,65307,13225
6000,50,2169,60251,90093,29842
6000,85,2202,52588,59889,7301
6000,144,2184,49758,68070,18312
6000,145,2131,46764,58716,11952
6000,4,2215,41433,58260,16827
6000,34,2211,52084,101197,49113
6000,159,2236,53062,65223,12161
6000,148,2243,50804,60374,9570
6000,101,2233,52669,79385,26716
6000,49,2193,52210,59202,6992
6000,51,2206,46005,63737,17732
6000,175,2174,57964,70648,12684
6000,89,2188,53339,66682,13343
6000,157,2175,53641,65069,11428
6000,133,2188,49305,63217,13912
6000,71,2189,79189,83005,3816
6000,33,2213,46210,64111,17901
6000,77,2203,55821,69265,13444
6000,42,2236,49281,65966,16685
6000,191,2207,57230,68072,10842
6000,105,2217,90833,110539,19706
6000,114,2210,67070,73544,6474
6000,57,2210,50885,94990,44105
6000,119,2216,54943,74803,19860
6000,50,2182,50436,67728,17292
6000,150,2235,59602,75251,15649
7000,129,2542,74844,90207,15363
7000,116,2580,67685,91568,23883
7000,58,2559,64314,76638,12324
7000,96,2570,76018,84154,8136
7000,138,2603,56362,72444,16082
7000,26,2628,63344,79397,16053
7000,183,2618,53544,67412,13868
7000,243,2594,79789,83364,3575
7000,156,2576,56139,83666,27527
7000,135,2592,78413,87566,9153
7000,121,2583,57659,83290,25631
7000,134,2593,67423,73534,6111
7000,114,2563,58052,78075,20023
7000,60,2578,63317,92115,28798
7000,105,2597,63118,75344,12226
7000,204,2592,80257,85708,5451
7000,239,2587,60884,82677,21793
7000,189,2613,54924,74771,19847
7000,98,2569,76866,89310,12444
7000,117,2636,56730,75456,18726
7000,69,2518,69071,99998,30927
7000,47,2582,88726,109321,20595
7000,56,2615,60569,89766,29197
7000,192,2577,59520,74824,15304
7000,205,2596,63826,73048,9222
7000,162,2567,69547,74531,4984
7000,107,2596,61479,81278,19799
7000,17,2592,68503,82240,13737
7000,79,2573,50924,76321,25397
7000,72,2591,68126,90222,22096
7000,200,2544,62643,85268,22625
7000,16,2591,63981,98344,34363
7000,100,2559,57036,104679,47643
7000,27,2567,60261,73307,13046
7000,116,2541,61793,98237,36444
7000,93,2572,77781,90502,12721
7000,121,2604,73868,76971,3103
7000,24,2552,65446,89878,24432
7000,83,2607,57350,88789,31439
7000,20,2580,70534,74676,4142
7000,165,2511,63969,87331,23362
7000,123,2583,71055,89332,18277
7000,73,2579,70253,75570,5317
7000,133,2577,60389,74822,14433
7000,56,2581,55208,70929,15721
7000,188,2567,59973,83249,23276
7000,135,2529,55906,78781,22875
7000,79,2604,78131,78329,198
7000,62,2624,59166,84960,25794
7000,106,2559,51384,76936,25552
8000,74,2948,70378,93075,22697
8000,130,2962,101681,109271,7590
8000,38,2944,66359,101768,35409
8000,206,2945,77070,99107,22037
8000,164,2945,77753,96028,18275
8000,88,3008,74340,87104,12764
8000,74,3001,69327,102744,33417
8000,40,2976,79169,94807,15638
8000,97,3002,72072,87565,15493
8000,46,2978,69304,97936,28632
8000,94,3003,73206,77032,3826
8000,60,2937,82875,97723,14848
8000,28,2910,71217,98916,27699
8000,179,2912,72039,86702,14663
8000,165,2998,71119,89889,18770
8000,165,2952,75841,107128,31287
8000,161,2965,83887,97460,13573
8000,51,2938,68015,99644,31629
8000,76,2930,70955,91654,20699
8000,80,2938,67018,85549,18531
8000,23,2933,64890,81719,16829
8000,141,2935,74322,109076,34754
8000,20,2971,68353,98354,30001
8000,156,2930,76107,93943,17836
8000,28,2924,90287,93146,2859
8000,22,2977,95884,96789,905
8000,83,2938,88400,118894,30494
8000,33,2925,71890,102188,30298
8000,165,2970,82965,92764,9799
8000,97,2924,77553,84030,6477
8000,134,2932,74665,96313,21648
8000,92,2956,84846,112079,27233
8000,153,2927,85099,89312,4213
8000,257,2884,76909,112689,35780
8000,122,3012,89787,100463,10676
8000,84,2898,68942,101480,32538
8000,155,2925,79065,107104,28039
8000,68,2998,75725,87911,12186
8000,94,2947,70421,104460,34039
8000,153,2892,65757,88870,23113
8000,35,2959,61448,87513,26065
8000,197,2937,65609,93549,27940
8000,20,2936,64325,85408,21083
8000,97,2931,70740,104332,33592
8000,101,2962,89821,95592,5771
8000,24,2937,93546,97761,4215
8000,161,2930,82808,89330,6522
8000,95,2958,92462,93923,1461
8000,206,2953,77127,92150,15023
8000,121,2956,66804,102009,35205
9000,195,3382,94876,138908,44032
9000,117,3339,78151,107451,29300
9000,39,3294,100297,103501,3204
9000,110,3304,132341,133566,1225
9000,156,3285,92059,120897,28838
9000,62,3264,88391,97113,8722
9000,41,3278,74108,95138,21030
9000,172,3224,80423,103703,23280
9000,77,3311,82542,103217,20675
9000,81,3289,82754,94055,11301
9000,115,3347,81558,126910,45352
9000,22,3252,85026,129461,44435
9000,45,3289,89262,111152,21890
9000,30,3346,103558,109914,6356
9000,212,3326,104282,106680,2398
9000,122,3333,98400,104606,6206
9000,140,3287,97226,122280,25054
9000,46,3324,82502,95238,12736
9000,67,3349,77210,103687,26477
9000,218,3328,94352,127738,33386
9000,175,3369,77688,107145,29457
9000,110,3311,89427,99708,10281
9000,79,3342,98167,135598,37431
9000,233,3320,82002,100195,18193
9000,56,3283,85233,96633,11400
9000,48,3292,86698,117467,30769
9000,132,3293,84003,109792,25789
9000,54,3291,77503,95736,18233
9000,33,3323,84519,124980,40461
9000,119,3326,71444,90205,18761
9000,156,3311,100805,128973,28168
9000,139,3336,88923,92735,3812
9000,134,3328,95214,109127,13913
9000,94,3242,88426,130818,42392
9000,124,3348,72145,102922,30777
9000,136,3345,77009,100166,23157
9000,48,3278,79813,120205,40392
9000,259,3338,93737,108724,14987
9000,195,3343,103906,131337,27431
9000,169,3314,101345,115448,14103
9000,125,3331,115355,136763,21408
9000,56,3293,80950,112822,31872
9000,32,3289,82350,98749,16399
9000,68,3312,97486,107532,10046
9000,130,3267,90845,105240,14395
9000,105,3346,75128,91090,15962
9000,117,3301,88006,102117,14111
9000,41,3273,87253,99571,12318
9000,16,3287,83852,102289,18437
9000,154,3306,106947,113522,6575
10000,51,3652,91404,128622,37218
10000,161,3656,86945,111492,24547
10000,109,3662,88753,107216,18463
10000,194,3677,102487,123075,20588
10000,154,3724,118731,132809,14078
10000,290,3761,112603,124318,11715
10000,3,3690,95054,107461,12407
10000,40,3692,100711,123571,22860
10000,95,3691,100620,120935,20315
10000,152,3713,108757,123243,14486
10000,95,3625,102294,108751,6457
10000,213,3681,101546,142569,41023
10000,83,3711,87028,132191,45163
10000,94,3642,110555,124980,14425
10000,149,3658,96656,110096,13440
10000,67,3689,91853,135249,43396
10000,36,3684,82773,118451,35678
10000,53,3703,103047,125476,22429
10000,184,3616,96563,122967,26404
10000,154,3744,97526,113161,15635
10000,147,3679,144080,154591,10511
10000,32,3682,101248,129476,28228
10000,131,3629,119425,146909,27484
10000,217,3638,91558,131602,40044
10000,268,3725,89014,121416,32402
10000,94,3586,92474,109260,16786
10000,70,3687,90568,137876,47308
10000,122,3677,95701,128576,32875
10000,58,3706,127843,128196,353
10000,97,3688,84521,106401,21880
10000,80,3696,95172,114654,19482
10000,82,3748,93867,140586,46719
10000,93,3705,96041,104935,8894
10000,94,3671,112974,146206,33232
10000,61,3759,88680,132797,44117
10000,134,3732,104141,109089,4948
10000,277,3652,93603,109366,15763
10000,184,3680,105779,126597,20818
10000,111,3677,107932,132552,24620
10000,98,3693,108987,117439,8452
10000,128,3699,105786,132909,27123
10000,42,3661,86973,105531,18558
10000,91,3652,88499,99117,10618
10000,67,3692,79054,120608,41554
10000,94,3640,74509,131362,56853
10000,271,3684,95034,111230,16196
10000,67,3693,105304,142336,37032
10000,50,3686,85896,138834,52938
10000,68,3619,91278,126107,34829
10000,143,3682,89371,118385,29014
11000,46,4013,107426,128668,21242
11000,153,4067,114892,128478,13586
11000,173,4081,100158,132905,32747
11000,130,4040,112432,177423,64991
11000,197,4072,99676,151175,51499
11000,38,4068,117694,141708,24014
11000,98,4000,119454,145601,26147
11000,197,4065,106982,144606,37624
11000,84,4023,111826,122300,10474
11000,91,4009,98213,120640,22427
11000,117,4069,143524,164867,21343
11000,276,4084,100598,127001,26403
11000,238,4044,129534,139464,9930
11000,80,4088,90420,177120,86700
11000,101,3971,84405,107001,22596
11000,159,4023,115762,130482,14720
11000,83,4021,87108,127521,40413
11000,146,4033,109893,144074,34181
11000,62,4087,94975,143170,48195
11000,155,3993,125580,144198,18618
11000,113,4047,116991,138543,21552
11000,81,4016,148875,170545,21670
11000,97,4086,115618,145770,30152
11000,176,4050,134452,144036,9584
11000,30,4025,108969,152245,43276
11000,36,4066,106095,128258,22163
11000,164,4077,102068,131554,29486
11000,49,3989,126789,146907,20118
11000,53,4081,89053,109057,20004
11000,138,4052,97924,139743,41819
11000,121,4045,85107,117701,32594
11000,48,4070,142877,151709,8832
11000,103,4112,96407,126792,30385
11000,119,4079,89852,118958,29106
11000,79,4041,88098,119958,31860
11000,165,4033,101487,111568,10081
11000,65,4079,87101,120280,33179
11000,66,4011,104915,133063,28148
11000,33,4034,105385,173493,68108
11000,78,3974,96720,132372,35652
11000,125,4037,118569,132878,14309
11000,123,4048,102582,121750,19168
11000,58,4037,122282,126558,4276
11000,170,4036,94729,134168,39439
11000,143,4096,107984,144052,36068
11000,145,4038,113030,139219,26189
11000,250,4050,102327,115213,12886
11000,160,4044,99828,147914,48086
11000,125,4075,105738,116956,11218
11000,234,4076,99563,131238,31675
12000,175,4369,121297,160147,38850
12000,173,4445,106517,126033,19516
12000,26,4397,163714,183015,19301
12000,261,4387,107507,127734,20227
12000,72,4361,100562,116036,15474
12000,45,4400,137546,141226,3680
12000,92,4439,133412,143290,9878
12000,166,4408,112311,197228,84917
12000,254,4368,111615,146445,34830
12000,220,4442,117931,161765,43834
12000,239,4377,112950,180253,67303
12000,146,4399,132767,141331,8564
12000,53,4398,93977,149823,55846
12000,119,4417,121062,163926,42864
12000,116,4458,106335,126350,20015
12000,241,4424,93384,131641,38257
12000,215,4413,117805,146221,28416
12000,135,4346,131321,159182,27861
12000,192,4384,98639,141711,43072
12000,41,4429,119836,153061,33225
12000,125,4374,131476,151446,19970
12000,117,4409,100684,118398,17714
12000,38,4436,139196,171184,31988
12000,158,4362,107316,133319,26003
12000,119,4424,113846,134670,20824
12000,142,4404,96434,135095,38661
12000,81,4398,121679,146069,24390
12000,29,4390,128025,145546,17521
12000,208,4371,104687,151314,46627
12000,188,4386,135412,144262,8850
12000,50,4335,112043,129101,17058
12000,207,4424,139900,143591,3691
12000,291,4479,119167,153593,34426
12000,93,4482,106029,141070,35041
12000,314,4411,115395,145175,29780
12000,190,4431,142805,162552,19747
12000,38,4368,170487,185689,15202
12000,220,4420,140635,148294,7659
12000,194,4410,139135,146119,6984
12000,94,4368,111147,159095,47948
12000,156,4490,95617,149933,54316
12000,94,4367,127279,147642,20363
12000,44,4368,111271,159716,48445
12000,152,4464,91818,130331,38513
12000,58,4399,128117,133629,5512
12000,159,4426,112105,128400,16295
12000,95,4470,124335,149630,25295
12000,135,4456,137318,139622,2304
12000,196,4459,103562,149068,45506
12000,147,4429,145425,147352,1927
13000,33,4772,115037,142990,27953
13000,115,4828,152293,167092,14799
13000,64,4773,112079,168724,56645
13000,151,4803,146144,154144,8000
13000,97,4813,114635,161609,46974
13000,155,4809,138731,178174,39443
13000,105,4853,173403,206231,32828
13000,193,4772,124894,136956,12062
13000,104,4746,116371,154160,37789
13000,70,4809,139533,186956,47423
13000,164,4821,120051,142897,22846
13000,58,4763,133421,168976,35555
13000,245,4778,112895,198073,85178
13000,399,4814,149513,176169,26656
13000,143,4800,138589,199479,60890
13000,40,4773,131178,138287,7109
13000,168,4811,129263,156323,27060
13000,212,4780,133844,194068,60224
13000,181,4800,123577,149027,25450
13000,78,4813,120407,154451,34044
13000,204,4808,145129,149109,3980
13000,81,4802,140267,151768,11501
13000,232,4754,110899,151347,40448
13000,98,4815,144405,199555,55150
13000,259,4749,110477,147566,37089
13000,15,4793,129304,157124,27820
13000,260,4871,120436,193344,72908
13000,60,4834,117171,170324,53153
13000,79,4746,132770,153123,20353
13000,88,4777,114911,186059,71148
13000,248,4798,159663,199465,39802
13000,171,4802,141411,146399,4988
13000,273,4803,126275,176898,50623
13000,129,4774,171858,178570,6712
13000,151,4832,149219,179085,29866
13000,192,4794,121126,160831,39705
13000,69,4839,122626,163781,41155
13000,137,4774,143896,165377,21481
13000,84,4790,120625,134797,14172
13000,281,4800,132053,150697,18644
13000,121,4788,112641,145808,33167
13000,253,4752,114270,141533,27263
13000,195,4707,129267,162354,33087
13000,107,4822,120254,174507,54253
13000,145,4799,119447,143842,24395
13000,47,4764,133606,181200,47594
13000,331,4811,112582,169045,56463
13000,243,4784,129000,173157,44157
13000,233,4809,118167,152790,34623
13000,124,4742,153193,160716,7523
14000,124,5181,169238,179199,9961
14000,23,5200,160596,187366,26770
14000,197,5142,121401,160224,38823
14000,58,5099,128661,150183,21522
14000,179,5126,168387,179550,11163
14000,115,5138,138792,177830,39038
14000,79,5191,169717,178212,8495
14000,100,5139,135250,176563,41313
14000,69,5169,129859,181948,52089
14000,222,5160,132546,181241,48695
14000,91,5101,134110,164761,30651
14000,26,5177,105463,190975,85512
14000,218,5137,129910,176575,46665
14000,173,5183,194467,222479,28012
14000,74,5163,147795,168965,21170
14000,80,5124,142613,182590,39977
14000,178,5137,156351,182471,26120
14000,261,5153,131086,155815,24729
14000,210,5074,137954,166804,28850
14000,139,5218,141269,169600,28331
14000,141,5142,155028,167262,12234
14000,218,5136,157055,159514,2459
14000,111,5145,139284,161352,22068
14000,162,5136,156209,176978,20769
14000,280,5113,129922,154926,25004
14000,106,5181,148419,179834,31415
14000,178,5089,129951,185512,55561
14000,259,5168,143449,207493,64044
14000,90,5118,149614,171253,21639
14000,142,5057,150430,165661,15231
14000,169,5086,162207,202062,39855
14000,156,5155,163195,182048,18853
14000,66,5137,119432,189534,70102
14000,202,5122,157158,178712,21554
14000,260,5165,135567,177457,41890
14000,170,5151,134125,165527,31402
14000,56,5115,122233,161341,39108
14000,50,5121,143787,182527,38740
14000,253,5101,119814,175607,55793
14000,285,5120,143118,154937,11819
14000,97,5192,123847,174774,50927
14000,153,5165,151214,159280,8066
14000,248,5134,125523,173398,47875
14000,306,5083,137439,163599,26160
14000,169,5173,107779,241311,133532
14000,168,5169,132016,184811,52795
14000,103,5186,129960,179986,50026
14000,59,5157,138828,170323,31495
14000,124,5152,161712,167869,6157
14000,158,5151,139325,171329,32004
15000,268,5595,197464,217203,19739
15000,260,5442,144325,199309,54984
15000,191,5509,149071,204179,55108
15000,53,5483,129655,223276,93621
15000,85,5570,136687,180712,44025
15000,307,5507,167296,176986,9690
15000,285,5518,137482,226495,89013
15000,67,5513,149955,216245,66290
15000,118,5526,146090,170817,24727
15000,67,5481,161878,192474,30596
15000,115,5463,135109,192631,57522
15000,82,5482,171986,209012,37026
15000,112,5463,142277,174423,32146
15000,198,5561,162784,187799,25015
15000,172,5484,163397,186727,23330
15000,110,5613,150793,166112,15319
15000,155,5512,141977,167035,25058
15000,67,5516,144045,173659,29614
15000,113,5516,203165,211951,8786
15000,183,5425,139798,169479,29681
15000,311,5506,124593,178575,53982
15000,314,5519,131827,231311,99484
15000,26,5529,135197,199677,64480
15000,215,5501,146458,190032,43574
15000,71,5537,167407,209929,42522
15000,171,5506,169649,231557,61908
15000,51,5513,141082,199514,58432
15000,46,5560,128142,165762,37620
15000,229,5534,176818,194749,17931
15000,71,5473,157710,181355,23645
15000,296,5504,139916,181024,41108
15000,245,5560,164719,194719,30000
15000,140,5505,144077,172015,27938
15000,319,5515,149260,177468,28208
15000,204,5511,153190,205812,52622
15000,192,5507,149005,184341,35336
15000,141,5478,126447,202414,75967
15000,258,5478,143572,228737,85165
15000,105,5490,191519,193151,1632
15000,190,5547,127954,170078,42124
15000,91,5525,156097,176302,20205
15000,236,5545,138795,165320,26525
15000,330,5558,157968,179597,21629
15000,133,5500,146598,246433,99835
15000,230,5544,156336,204540,48204
15000,124,5518,171331,215011,43680
15000,199,5536,154765,170923,16158
15000,87,5457,141688,181944,40256
15000,139,5472,146777,183680,36903
15000,105,5499,143064,168069,25005
16000,49,5928,153189,183877,30688
16000,79,5890,145439,175190,29751
16000,123,5898,154865,182767,27902
16000,101,5904,153506,197318,43812
16000,126,5848,169143,207757,38614
16000,266,5861,153185,180902,27717
16000,140,5857,150102,199541,49439
16000,84,5876,160737,223000,62263
16000,47,5847,151336,213488,62152
16000,309,5875,152634,210934,58300
16000,136,5922,139678,169189,29511
16000,132,5834,136359,204176,67817
16000,109,5898,163146,178052,14906
16000,184,5879,212670,230423,17753
16000,166,5852,151939,204462,52523
16000,220,5811,156203,193110,36907
16000,136,5877,155187,183963,28776
16000,52,5853,180994,191834,10840
16000,232,5910,163346,182592,19246
16000,69,5854,142828,186192,43364
16000,110,5895,165136,187237,22101
16000,117,5895,187608,195601,7993
16000,91,5931,147777,199883,52106
16000,168,5903,184488,205521,21033
16000,157,5956,157771,217262,59491
16000,66,5911,162620,206552,43932
16000,317,5904,216426,239146,22720
16000,220,5862,158086,183886,25800
16000,199,5896,175600,200180,24580
16000,110,5948,215424,266708,51284
16000,141,5911,146983,217653,70670
16000,195,5893,188239,204849,16610
16000,214,5873,203605,220288,16683
16000,78,5872,168215,212025,43810
16000,47,5922,156499,220714,64215
16000,276,5837,174802,209732,34930
16000,120,5887,147738,170208,22470
16000,84,5917,165831,197650,31819
16000,141,5899,160905,208794,47889
16000,204,5908,168319,220496,52177
16000,61,5927,191466,210504,19038
16000,237,5846,140431,185115,44684
16000,343,5841,141983,178823,36840
16000,98,5911,168345,221673,53328
16000,211,5870,151185,180009,28824
16000,198,5875,184397,261965,77568
16000,66,5896,160043,182366,22323
16000,101,5920,160851,226692,65841
16000,158,5877,207441,234481,27040
16000,247,5879,160171,190680,30509
17000,131,6246,152066,208249,56183
17000,244,6286,254391,262136,7745
17000,32,6204,247723,264188,16465
17000,69,6195,162507,207456,44949
17000,77,6236,147344,243595,96251
17000,75,6239,184356,237236,52880
17000,237,6205,155368,247305,91937
17000,37,6263,186628,212259,25631
17000,194,6222,179958,210066,30108
17000,151,6334,186559,203325,16766
17000,243,6247,163498,283930,120432
17000,116,6267,222843,260485,37642
17000,229,6311,188476,205465,16989
17000,91,6266,203703,229146,25443
17000,88,6298,188330,254905,66575
17000,283,6264,162033,203101,41068
17000,134,6215,208917,213084,4167
17000,309,6271,196877,223101,26224
17000,78,6203,186961,209658,22697
17000,155,6262,162195,212961,50766
17000,111,6297,158805,196697,37892
17000,28,6279,177131,197465,20334
17000,108,6246,186836,222411,35575
17000,38,6270,174866,239435,64569
17000,203,6247,178983,194953,15970
17000,60,6268,181845,216883,35038
17000,255,6283,186565,202067,15502
17000,109,6195,160475,196447,35972
17000,182,6236,225935,234431,8496
17000,83,6154,156373,223893,67520
17000,252,6301,166235,191159,24924
17000,200,6244,149142,189440,40298
17000,346,6253,166989,228178,61189
17000,131,6212,147812,212758,64946
17000,213,6218,191960,199118,7158
17000,198,6266,240455,252661,12206
17000,96,6270,252646,255890,3244
17000,168,6250,170533,231617,61084
17000,303,6200,156595,209908,53313
17000,277,6311,189373,213139,23766
17000,256,6234,168199,197862,29663
17000,91,6255,150730,177600,26870
17000,285,6207,216854,239457,22603
17000,159,6261,200750,221269,20519
17000,51,6240,177811,201889,24078
17000,313,6245,216362,224919,8557
17000,304,6229,197976,253711,55735
17000,30,6239,173110,276456,103346
17000,193,6292,157751,201004,43253
17000,259,6159,175204,240968,65764
18000,116,6607,206113,219856,13743
18000,174,6522,207173,232656,25483
18000,203,6642,215909,219511,3602
18000,198,6591,197095,245038,47943
18000,186,6638,141332,211158,69826
18000,39,6578,172021,279780,107759
18000,218,6622,208510,212116,3606
18000,162,6525,163143,227150,64007
18000,193,6661,188294,258730,70436
18000,82,6553,208801,229882,21081
18000,51,6712,191092,221660,30568
18000,132,6625,181564,237786,56222
18000,99,6665,176993,227591,50598
18000,179,6589,174633,210648,36015
18000,174,6561,161670,200825,39155
18000,154,6572,202398,274205,71807
18000,196,6539,216146,238666,22520
18000,127,6629,191991,228116,36125
18000,119,6626,180821,211516,30695
18000,136,6590,179655,272104,92449
18000,93,6653,189339,262858,73519
18000,312,6638,180890,314316,133426
18000,208,6640,171241,220287,49046
18000,186,6651,162018,214058,52040
18000,331,6626,213728,222942,9214
18000,201,6655,184884,233179,48295
18000,156,6634,176290,287089,110799
18000,175,6601,180849,238581,57732
18000,236,6615,175945,273908,97963
18000,166,6658,225289,314711,89422
18000,151,6629,215693,310589,94896
18000,131,6650,167580,236622,69042
18000,59,6608,219584,252818,33234
18000,71,6605,197822,259248,61426
18000,162,6620,200973,275462,74489
18000,44,6696,246541,252257,5716
18000,92,6598,179851,233709,53858
18000,367,6622,194311,213718,19407
18000,152,6687,161081,236908,75827
18000,89,6583,172408,228223,55815
18000,166,6647,175252,300162,124910
18000,160,6580,157053,199430,42377
18000,95,6609,155409,212518,57109
18000,229,6658,206099,262093,55994
18000,64,6560,200164,228569,28405
18000,249,6624,195753,238728,42975
18000,171,6673,199556,224279,24723
18000,248,6515,162522,215128,52606
18000,245,6592,174534,243942,69408
18000,137,6589,179299,268377,89078
19000,328,6979,206289,244236,37947
19000,261,7026,161464,215647,54183
19000,193,7044,211696,221045,9349
19000,350,6994,190496,220748,30252
19000,329,6879,179016,209007,29991
19000,204,6955,195315,291689,96374
19000,190,7024,209806,258078,48272
19000,193,7051,189237,243344,54107
19000,37,6925,187415,218208,30793
19000,311,6985,194281,223438,29157
19000,287,6979,190237,222418,32181
19000,79,7088,223708,227118,3410
19000,204,7082,199652,279251,79599
19000,80,6916,212805,264198,51393
19000,173,7026,175643,245470,69827
19000,196,7017,201992,257706,55714
19000,147,7026,191866,254699,62833
19000,227,6961,177429,264803,87374
19000,204,6769,217516,252077,34561
19000,159,7044,177937,252155,74218
19000,266,6984,196570,237236,40666
19000,73,6994,185505,216835,31330
19000,106,6936,182306,242699,60393
19000,73,6991,195228,213547,18319
19000,195,7013,202145,258472,56327
19000,139,6931,223357,275826,52469
19000,74,6956,182622,253017,70395
19000,322,7026,227920,247530,19610
19000,304,7018,217030,304776,87746
19000,78,7003,208059,235283,27224
19000,103,7040,189858,240480,50622
19000,116,6952,181243,282757,101514
19000,103,6983,193081,232489,39408
19000,326,7008,184116,294298,110182
19000,247,6928,196910,217930,21020
19000,122,6979,294634,331783,37149
19000,253,7019,177482,215889,38407
19000,132,7058,196029,257261,61232
19000,166,6995,185228,247713,62485
19000,211,7022,178450,225610,47160
19000,231,6917,215690,238325,22635
19000,138,7061,213730,257669,43939
19000,147,6976,173262,233772,60510
19000,73,7020,230524,234975,4451
19000,137,6969,228394,237955,9561
19000,195,7070,216043,293130,77087
19000,133,6940,201440,222699,21259
19000,57,7014,185117,243740,58623
19000,158,6953,196249,247870,51621
19000,128,6959,166896,229659,62763
20000,289,7374,190341,233529,43188
20000,275,7365,223368,276676,53308
20000,226,7394,273438,301803,28365
20000,150,7363,250816,267185,16369
20000,52,7331,209810,228917,19107
20000,213,7340,185234,245913,60679
20000,223,7336,188959,300385,111426
20000,91,7333,210671,243231,32560
20000,144,7389,219320,258025,38705
20000,129,7417,225019,246931,21912
20000,151,7366,285163,287048,1885
20000,80,7350,171254,220807,49553
20000,193,7411,215264,255852,40588
20000,252,7399,209430,244232,34802
20000,298,7361,184099,252489,68390
20000,40,7304,238208,245148,6940
20000,86,7357,207345,282158,74813
20000,171,7290,204268,236099,31831
20000,421,7383,202569,248080,45511
20000,163,7412,199225,248601,49376
20000,116,7418,177096,290458,113362
20000,245,7322,240688,270524,29836
20000,143,7325,188726,249105,60379
20000,272,7393,188131,250870,62739
20000,238,7334,238013,238417,404
20000,133,7389,209536,229630,20094
20000,237,7379,228623,246301,17678
20000,222,7385,215473,238147,22674
20000,249,7353,201362,230864,29502
20000,159,7359,215091,235521,20430
20000,134,7376,272165,306305,34140
20000,139,7383,188696,282180,93484
20000,181,7420,187270,275791,88521
20000,288,7417,209697,264004,54307
20000,164,7306,198797,266813,68016
20000,94,7438,234241,293283,59042
20000,100,7313,210186,241670,31484
20000,155,7298,185707,236961,51254
20000,261,7397,201553,245181,43628
20000,184,7394,214300,242926,28626
20000,194,7448,169612,239858,70246
20000,317,7378,234056,305284,71228
20000,89,7321,189624,234898,45274
20000,314,7402,163171,304921,141750
20000,265,7404,181365,399067,217702
20000,234,7370,203609,273369,69760
20000,166,7360,239462,242336,2874
20000,12,7369,207300,255140,47840
20000,105,7396,198109,263838,65729
20000,144,7392,170634,272633,101999
21000,94,7746,215764,276006,60242
21000,104,7772,254173,275603,21430
21000,282,7645,203899,318372,114473
21000,174,7748,210674,235490,24816
21000,188,7714,248350,329726,81376
21000,156,7741,247356,278596,31240
21000,189,7722,222963,339606,116643
21000,133,7762,219378,249393,30015
21000,225,7711,199127,251852,52725
21000,109,7712,184023,243260,59237
21000,337,7786,233539,322780,89241
21000,65,7749,208982,335821,126839
21000,274,7788,211500,251563,40063
21000,128,7733,208203,250441,42238
21000,237,7725,184165,235589,51424
21000,198,7750,216982,321306,104324
21000,206,7683,187134,219850,32716
21000,85,7761,203011,254868,51857
21000,210,7676,234694,272916,38222
21000,351,7774,181501,258041,76540
21000,164,7724,235531,267143,31612
21000,167,7781,216326,248265,31939
21000,159,7763,249906,284860,34954
21000,157,7752,199932,283390,83458
21000,187,7706,218108,261668,43560
21000,297,7648,211022,306048,95026
21000,515,7736,229935,293500,63565
21000,329,7663,268423,329267,60844
21000,271,7749,243327,275706,32379
21000,59,7719,207997,243299,35302
21000,148,7771,217984,266234,48250
21000,271,7691,193038,299344,106306
21000,452,7670,226655,289884,63229
21000,98,7728,196885,247213,50328
21000,108,7631,252282,272243,19961
21000,114,7665,233916,271910,37994
21000,279,7712,187893,269966,82073
21000,63,7758,202373,269385,67012
21000,271,7789,300408,307141,6733
21000,61,7771,238838,267537,28699
21000,214,7748,183328,264445,81117
21000,344,7824,218683,297062,78379
21000,32,7717,249183,272750,23567
21000,208,7763,217365,290555,73190
21000,58,7727,220777,312575,91798
21000,15,7685,209509,271610,62101
21000,103,7700,208916,287851,78935
21000,242,7705,205162,278269,73107
21000,111,7773,213614,277979,64365
21000,160,7722,175964,225280,49316
22000,70,8083,257214,283706,26492
22000,248,8089,213818,306533,92715
22000,387,8106,219204,269548,50344
22000,415,8117,218669,288926,70257
22000,204,8123,216230,266831,50601
22000,176,8138,262652,341233,78581
22000,141,8051,204804,288643,83839
22000,103,8072,204432,267623,63191
22000,7,8055,213676,379009,165333
22000,148,8138,202287,275792,73505
22000,399,8106,233700,341736,108036
22000,324,8122,213221,284534,71313
22000,212,8095,188775,318474,129699
22000,318,8129,227603,283867,56264
22000,183,8064,230406,336502,106096
22000,394,8091,236789,324712,87923
22000,306,8125,232391,258893,26502
22000,129,8065,264420,306973,42553
22000,233,8019,211459,283530,72071
22000,326,8051,223864,314035,90171
22000,103,8085,295544,310255,14711
22000,175,8057,262026,314109,52083
22000,180,8057,211121,273007,61886
22000,160,8129,226054,288234,62180
22000,237,8053,221104,240108,19004
22000,29,8007,287874,305933,18059
22000,164,7995,226727,262318,35591
22000,68,8023,255252,288893,33641
22000,388,8181,231940,328339,96399
22000,157,8103,216454,335651,119197
22000,196,8132,197332,397897,200565
22000,97,8062,223318,265457,42139
22000,21,8074,197519,259796,62277
22000,77,8155,253666,311191,57525
22000,171,8082,217590,309384,91794
22000,238,8113,297793,321814,24021
22000,104,8037,222096,285484,63388
22000,217,8118,237052,268687,31635
22000,264,8105,199177,328059,128882
22000,169,8168,199198,280905,81707
22000,255,8081,213249,282781,69532
22000,236,8136,262283,322094,59811
22000,145,8126,217951,303302,85351
22000,263,8132,210590,272199,61609
22000,469,8083,233926,290023,56097
22000,320,8125,261122,315294,54172
22000,114,8146,177628,247878,70250
22000,371,8081,217785,301835,84050
22000,381,8042,204047,268507,64460
22000,240,8078,203643,282531,78888
23000,83,8459,246810,258787,11977
23000,140,8522,250895,340529,89634
23000,184,8394,255449,277841,22392
23000,180,8418,257542,320600,63058
23000,140,8499,245111,279227,34116
23000,199,8460,281012,298124,17112
23000,236,8459,204342,328413,124071
23000,110,8502,253511,286552,33041
23000,205,8527,278066,303856,25790
23000,334,8433,234362,311279,76917
23000,247,8549,229479,290472,60993
23000,92,8454,243555,308566,65011
23000,43,8337,198175,368932,170757
23000,92,8457,217056,301127,84071
23000,177,8440,296730,350813,54083
23000,178,8402,248517,315084,66567
23000,147,8405,212300,311580,99280
23000,118,8454,240039,264080,24041
23000,376,8462,331476,353217,21741
23000,116,8428,255106,288842,33736
23000,167,8435,272662,329557,56895
23000,153,8449,314332,314564,232
23000,227,8499,318182,344514,26332
23000,231,8413,346110,354752,8642
23000,293,8439,217955,268581,50626
23000,279,8404,241723,314659,72936
23000,316,8445,238136,268660,30524
23000,295,8586,258322,286401,28079
23000,324,8439,262496,345375,82879
23000,289,8476,200482,352885,152403
23000,454,8463,232164,279044,46880
23000,303,8460,279309,295108,15799
23000,189,8469,268353,349085,80732
23000,130,8505,260524,303194,42670
23000,297,8462,276941,316080,39139
23000,152,8428,237278,280220,42942
23000,159,8528,240861,310285,69424
23000,137,8471,191595,329040,137445
23000,124,8459,293259,365779,72520
23000,150,8381,253714,297245,43531
23000,293,8418,192238,273856,81618
23000,229,8468,273744,286116,12372
23000,197,8483,310628,322032,11404
23000,407,8507,249406,292114,42708
23000,136,8462,231698,292909,61211
23000,95,8473,241485,336735,95250
23000,244,8397,211453,266095,54642
23000,267,8505,209125,292796,83671
23000,161,8506,206086,277607,71521
23000,110,8543,214346,318539,104193
24000,194,8882,287589,335131,47542
24000,203,8791,244589,354414,109825
24000,163,8839,261713,283850,22137
24000,97,8831,243738,351218,107480
24000,425,8847,268683,306894,38211
24000,167,8930,216639,278312,61673
24000,339,8816,265192,331258,66066
24000,216,8878,270227,299355,29128
24000,372,8869,278436,313169,34733
24000,40,8770,262205,342994,80789
24000,115,8853,250122,294569,44447
24000,108,8845,250045,384161,134116
24000,303,8848,228885,284665,55780
24000,33,8753,301639,341903,40264
24000,176,8786,224681,306825,82144
24000,190,8850,212128,293493,81365
24000,320,8806,290993,294278,3285
24000,166,8906,230784,340789,110005
24000,65,8803,249532,283723,34191
24000,181,8879,280020,295079,15059
24000,129,8845,209566,305478,95912
24000,38,8767,238519,292250,53731
24000,202,8874,312483,385174,72691
24000,159,8796,254380,310909,56529
24000,280,8749,257211,331344,74133
24000,132,8829,224440,317776,93336
24000,163,8824,233814,281119,47305
24000,68,8763,271046,305994,34948
24000,543,8880,281822,299357,17535
24000,61,8837,228500,299245,70745
24000,168,8853,314633,323569,8936
24000,4,8760,223386,345736,122350
24000,76,8861,243704,329993,86289
24000,184,8860,320647,353565,32918
24000,201,8787,302791,329273,26482
24000,69,8755,215602,334197,118595
24000,192,8824,260479,276015,15536
24000,62,8860,205222,331471,126249
24000,171,8930,251067,371807,120740
24000,162,8820,269112,308133,39021
24000,284,8888,331035,332122,1087
24000,369,8882,228381,315070,86689
24000,43,8825,264782,340768,75986
24000,115,8823,270136,296573,26437
24000,280,8859,270196,312782,42586
24000,51,8768,263658,298736,35078
24000,193,8770,216310,324748,108438
24000,97,8845,336603,350723,14120
24000,54,8824,260772,297311,36539
24000,160,8854,221345,279576,58231
25000,221,9175,228711,316049,87338
25000,157,9206,280493,372684,92191
25000,396,9172,303829,341558,37729
25000,113,9197,278957,317250,38293
25000,173,9206,325243,353405,28162
25000,85,9273,246377,322035,75658
25000,199,9253,279460,318120,38660
25000,122,9196,249132,366022,116890
25000,293,9196,251334,317255,65921
25000,202,9109,288859,319494,30635
25000,517,9137,260196,320669,60473
25000,276,9116,282901,354012,71111
25000,447,9212,275523,352340,76817
25000,168,9124,268351,326871,58520
25000,165,9203,247222,285737,38515
25000,464,9133,297746,369760,72014
25000,174,9236,294524,383909,89385
25000,172,9138,243191,314970,71779
25000,330,9201,318216,321559,3343
25000,130,9202,250628,309250,58622
25000,67,9126,232213,302562,70349
25000,82,9151,273547,319715,46168
25000,232,9237,241770,276649,34879
25000,141,9233,241534,317589,76055
25000,102,9188,218640,332699,114059
25000,188,9204,257837,310138,52301
25000,270,9185,221672,343411,121739
25000,198,9195,382621,387080,4459
25000,196,9197,228633,317992,89359
25000,236,9100,294398,336192,41794
25000,391,9144,280936,302540,21604
25000,242,9176,264438,308208,43770
25000,201,9208,305614,402219,96605
25000,83,9169,255549,343637,88088
25000,324,9148,254163,278767,24604
25000,216,9163,239554,362121,122567
25000,232,9209,336933,351727,14794
25000,147,9134,261062,319315,58253
25000,189,9162,242163,287383,45220
25000,215,9300,290227,331716,41489
25000,97,9195,281187,319414,38227
25000,63,9252,226088,313153,87065
25000,233,9229,259718,293982,34264
25000,150,9237,317348,369443,52095
25000,212,9275,331214,345962,14748
25000,101,9196,287165,307171,20006
25000,194,9245,241729,365491,123762
25000,188,9135,281233,329288,48055
25000,308,9150,276345,340531,64186
25000,42,9195,301508,358427,56919
26000,181,9563,250574,365540,114966
26000,134,9573,283587,345589,62002
26000,265,9499,333157,385902,52745
26000,296,9659,240109,332331,92222
26000,164,9599,275752,325446,49694
26000,143,9517,300483,416105,115622
26000,115,9467,253376,378040,124664
26000,234,9581,255947,339332,83385
26000,229,9578,269086,364758,95672
26000,72,9544,316067,343925,27858
26000,124,9643,353002,375704,22702
26000,185,9568,232583,339349,106766
26000,324,9445,243487,311273,67786
26000,185,9588,253153,361077,107924
26000,17,9535,307129,357166,50037
26000,114,9500,252939,358608,105669
26000,54,9562,306696,328623,21927
26000,308,9490,247606,327976,80370
26000,106,9532,275462,402806,127344
26000,252,9595,362895,380494,17599
26000,74,9573,235441,329445,94004
26000,56,9577,265253,323942,58689
26000,190,9501,318752,380576,61824
26000,263,9653,304078,321366,17288
26000,391,9549,254607,327703,73096
26000,133,9659,255393,305255,49862
26000,278,9441,255148,334852,79704
26000,144,9574,292210,324038,31828
26000,242,9568,233372,306758,73386
26000,220,9577,275240,386725,111485
26000,196,9613,287340,337090,49750
26000,146,9537,318803,388206,69403
26000,185,9594,328070,360972,32902
26000,353,9562,248617,372940,124323
26000,115,9543,296941,329986,33045
26000,165,9520,284610,369813,85203
26000,363,9535,294393,304849,10456
26000,97,9606,381777,383507,1730
26000,491,9543,256763,327776,71013
26000,406,9488,293923,320172,26249
26000,234,9523,254427,311195,56768
26000,474,9533,386342,395214,8872
26000,45,9575,235895,317617,81722
26000,187,9536,304778,383160,78382
26000,172,9529,389124,432018,42894
26000,97,9600,251592,287834,36242
26000,476,9462,393070,399827,6757
26000,222,9510,283572,347244,63672
26000,311,9581,254256,341372,87116
26000,81,9493,247398,294726,47328
27000,489,9986,250480,363205,112725
27000,248,9942,294365,333708,39343
27000,316,9950,308492,348972,40480
27000,73,9960,320332,357946,37614
27000,388,9840,270449,405929,135480
27000,84,9989,312765,390192,77427
27000,189,9784,402956,464774,61818
27000,112,9936,309993,390766,80773
27000,146,9921,270434,342077,71643
27000,537,9927,307608,380922,73314
27000,138,9898,258521,327904,69383
27000,167,9917,310241,360659,50418
27000,206,9932,267739,375517,107778
27000,148,10024,274523,346582,72059
27000,135,9928,273505,370103,96598
27000,186,9890,333173,359503,26330
27000,193,9905,264656,316720,52064
27000,307,9901,261422,352688,91266
27000,245,9863,247737,365531,117794
27000,161,9893,293288,353228,59940
27000,204,10026,285286,377364,92078
27000,115,9859,245483,317557,72074
27000,442,9968,292136,337797,45661
27000,68,9874,266622,393992,127370
27000,128,9879,259122,373460,114338
27000,141,9924,327333,342980,15647
27000,129,9898,378234,405177,26943
27000,205,10017,258947,319601,60654
27000,300,9883,278778,433478,154700
27000,304,9990,305891,389393,83502
27000,57,9894,289280,354243,64963
27000,176,9899,288095,356663,68568
27000,60,9877,283577,347208,63631
27000,208,9974,310635,446454,135819
27000,334,9899,296858,361424,64566
27000,54,9905,333900,389880,55980
27000,273,9924,265697,341092,75395
27000,332,9938,286187,359300,73113
27000,144,9973,269694,381797,112103
27000,211,9918,272405,488559,216154
27000,177,9892,434357,447235,12878
27000,308,9883,316597,347586,30989
27000,239,10004,264007,358634,94627
27000,231,10038,244860,317428,72568
27000,241,9955,353874,386060,32186
27000,282,10059,314149,332973,18824
27000,179,9906,265823,400420,134597
27000,198,9865,268330,374977,106647
27000,119,9945,349030,430535,81505
27000,157,9913,264907,421709,156802
28000,39,10311,335289,347683,12394
28000,141,10357,318104,409351,91247
28000,316,10133,264574,376279,111705
28000,296,10321,317056,352198,35142
28000,55,10344,338511,354728,16217
28000,85,10181,329928,381123,51195
28000,305,10311,276185,342085,65900
28000,39,10309,324691,363497,38806
28000,177,10300,253770,371692,117922
28000,284,10402,312548,390009,77461
28000,251,10207,321699,409152,87453
28000,342,10311,258799,356982,98183
28000,224,10280,392202,408962,16760
28000,313,10357,291034,375988,84954
28000,144,10265,338115,357871,19756
28000,138,10341,330481,361135,30654
28000,184,10196,320006,360776,40770
28000,97,10365,263072,380515,117443
28000,147,10321,277831,379883,102052
28000,203,10367,385103,390974,5871
28000,362,10290,298397,335490,37093
28000,141,10427,315370,364072,48702
28000,298,10216,382611,412833,30222
28000,307,10254,288900,356305,67405
28000,62,10260,264697,362060,97363
28000,70,10254,279173,351342,72169
28000,509,10313,338180,379459,41279
28000,560,10238,294413,356586,62173
28000,301,10319,326424,335256,8832
28000,341,10318,269301,366788,97487
28000,146,10359,308768,352586,43818
28000,239,10256,287879,343353,55474
28000,307,10387,298121,419814,121693
28000,190,10313,284320,419645,135325
28000,210,10308,318446,366449,48003
28000,88,10290,376560,383082,6522
28000,142,10320,352117,411657,59540
28000,162,10359,291133,365736,74603
28000,357,10243,417491,421386,3895
28000,308,10321,290404,418046,127642
28000,88,10375,277859,345227,67368
28000,114,10244,297719,378051,80332
28000,221,10284,328439,378453,50014
28000,55,10335,332407,354168,21761
28000,76,10352,288017,336312,48295
28000,175,10315,303006,407416,104410
28000,239,10341,278741,411629,132888
28000,71,10256,313153,375046,61893
28000,157,10259,345779,379093,33314
28000,267,10344,304380,404608,100228
29000,80,10698,299429,337009,37580
29000,72,10649,271450,370620,99170
29000,394,10711,351172,386572,35400
29000,607,10676,271052,358200,87148
29000,202,10693,246932,390074,143142
29000,222,10696,290673,377281,86608
29000,165,10752,320143,449462,129319
29000,322,10586,300340,365708,65368
29000,184,10743,360067,382435,22368
29000,302,10712,269192,354434,85242
29000,279,10691,328445,360040,31595
29000,169,10718,317358,380125,62767
29000,453,10712,325851,373181,47330
29000,79,10701,355695,401629,45934
29000,197,10655,267019,376241,109222
29000,29,10634,333660,426212,92552
29000,244,10680,348073,447337,99264
29000,330,10582,366695,423126,56431
29000,79,10698,321472,401553,80081
29000,284,10646,338646,423119,84473
29000,374,10631,343944,379815,35871
29000,214,10625,330142,358645,28503
29000,146,10611,373493,378729,5236
29000,37,10677,334158,343662,9504
29000,73,10623,331169,381054,49885
29000,143,10685,300822,334561,33739
29000,12,10685,308112,358240,50128
29000,233,10668,283695,373458,89763
29000,209,10638,307866,411048,103182
29000,58,10612,269551,393454,123903
29000,116,10693,290088,362043,71955
29000,131,10685,328369,375804,47435
29000,540,10749,324330,380774,56444
29000,143,10685,307516,491772,184256
29000,49,10704,341288,396482,55194
29000,174,10725,313224,395948,82724
29000,312,10699,300751,443169,142418
29000,352,10756,298215,370793,72578
29000,176,10632,299548,411367,111819
29000,487,10604,311240,427268,116028
29000,168,10680,304242,401972,97730
29000,488,10519,261898,373952,112054
29000,410,10576,317289,377984,60695
29000,162,10700,317677,399601,81924
29000,127,10618,355734,383469,27735
29000,148,10609,294256,369722,75466
29000,422,10660,292881,361401,68520
29000,199,10705,337674,383405,45731
29000,153,10627,358688,388324,29636
29000,32,10558,259412,383644,124232
30000,129,11076,272860,357330,84470
30000,485,11045,310919,392779,81860
30000,102,11084,310191,400618,90427
30000,279,11048,309184,373881,64697
30000,299,11021,274144,358613,84469
30000,257,10975,296026,426690,130664
30000,102,11049,293634,355426,61792
30000,421,11054,339374,352602,13228
30000,458,11032,309049,548885,239836
30000,399,11044,370128,408697,38569
30000,432,11008,320986,465824,144838
30000,72,10986,345229,377231,32002
30000,411,11051,373416,380884,7468
30000,394,10967,293085,427498,134413
30000,148,11124,316839,486458,169619
30000,219,10939,346888,367315,20427
30000,131,10970,360137,391063,30926
30000,161,11070,297080,464601,167521
30000,403,11027,397139,422619,25480
30000,332,11034,316407,343187,26780
30000,158,11030,359306,422958,63652
30000,164,11103,291959,431940,139981
30000,82,11010,291779,397742,105963
30000,142,11114,339788,389644,49856
30000,333,10951,324204,454299,130095
30000,359,11006,319224,329410,10186
30000,284,11003,303175,420904,117729
30000,243,10983,282109,429608,147499
30000,205,11023,350172,440350,90178
30000,62,10967,290359,339957,49598
30000,381,11008,306394,435662,129268
30000,360,11110,314848,428768,113920
30000,103,11133,364972,411596,46624
30000,159,10977,400748,506148,105400
30000,149,11084,290556,419072,128516
30000,377,10969,350577,432014,81437
30000,266,11004,332063,439336,107273
30000,71,11017,307099,396523,89424
30000,262,11095,322276,362646,40370
30000,382,11023,296976,399241,102265
30000,136,11096,273644,375752,102108
30000,141,11025,332234,421243,89009
30000,287,11048,354267,379978,25711
30000,301,10979,347111,426630,79519
30000,208,10988,325683,441442,115759
30000,172,11006,388926,401865,12939
30000,237,11062,467663,487295,19632
30000,422,11083,295564,480039,184475
30000,49,11027,315774,415311,99537
30000,453,10991,298094,345841,47747
31000,302,11407,361432,447047,85615
31000,115,11478,314495,378459,63964
31000,414,11417,334165,617111,282946
31000,382,11370,296119,558730,262611
31000,171,11397,353067,424245,71178
31000,77,11397,414258,469528,55270
31000,94,11379,340974,420401,79427
31000,73,11365,314278,420218,105940
31000,337,11398,368237,409830,41593
31000,460,11375,388975,452050,63075
31000,103,11397,315247,381216,65969
31000,461,11429,380286,455323,75037
31000,254,11492,276310,415041,138731
31000,231,11422,356858,437751,80893
31000,587,11403,302763,392670,89907
31000,246,11354,321246,365616,44370
31000,449,11427,306255,397698,91443
31000,172,11446,339794,402969,63175
31000,354,11409,344200,490260,146060
31000,193,11378,350610,384727,34117
31000,165,11323,416901,454430,37529
31000,83,11370,499666,515036,15370
31000,258,11277,362132,392778,30646
31000,203,11459,290646,393944,103298
31000,224,11344,331806,408259,76453
31000,441,11437,347184,409955,62771
31000,227,11470,363177,460134,96957
31000,342,11344,331765,463604,131839
31000,18,11433,304508,417209,112701
31000,462,11307,293619,374134,80515
31000,185,11337,347323,379255,31932
31000,216,11342,356256,472889,116633
31000,269,11261,351968,374681,22713
31000,257,11369,346410,409585,63175
31000,155,11340,343054,443371,100317
31000,149,11429,293162,439913,146751
31000,262,11483,311476,416857,105381
31000,140,11445,376339,464348,88009
31000,266,11435,359431,443203,83772
31000,104,11443,276624,358468,81844
31000,239,11368,290343,434931,144588
31000,76,11362,373987,395036,21049
31000,48,11386,328272,410953,82681
31000,87,11448,355262,399337,44075
31000,324,11394,290735,366960,76225
31000,74,11469,394696,621228,226532
31000,64,11466,413858,465518,51660
31000,316,11339,339905,408792,68887
31000,346,11413,338077,423192,85115
31000,106,11499,344119,437530,93411
32000,326,11786,351276,386113,34837
32000,192,11756,322783,467201,144418
32000,271,11754,321439,361614,40175
32000,225,11758,371452,447711,76259
32000,139,11702,316566,391158,74592
32000,182,11759,342550,398783,56233
32000,274,11708,311182,435664,124482
32000,403,11686,315720,425014,109294
32000,250,11752,420542,502534,81992
32000,303,11773,404174,409767,5593
32000,135,11785,318394,446420,128026
32000,326,11768,373349,421530,48181
32000,71,11760,333116,493477,160361
32000,129,11733,294736,399406,104670
32000,118,11764,370061,412186,42125
32000,314,11703,310423,430020,119597
32000,204,11686,343780,405379,61599
32000,107,11797,321814,427924,106110
32000,273,11625,324484,436755,112271
32000,410,11776,314586,510833,196247
32000,280,11739,351908,469299,117391
32000,78,11792,370623,393303,22680
32000,119,11688,336746,385611,48865
32000,145,11741,325159,387215,62056
32000,142,11838,321388,441056,119668
32000,92,11751,338406,437224,98818
32000,255,11818,347523,405144,57621
32000,305,11758,321764,390142,68378
32000,128,11858,303034,372945,69911
32000,52,11747,334606,426910,92304
32000,263,11790,369437,419879,50442
32000,229,11739,391019,494434,103415
32000,278,11753,367939,405110,37171
32000,487,11678,362803,398439,35636
32000,84,11729,357663,394378,36715
32000,185,11834,342951,377382,34431
32000,58,11805,402842,505749,102907
32000,294,11855,336568,430030,93462
32000,438,11746,365340,438790,73450
32000,406,11740,410523,414201,3678
32000,109,11808,313867,478655,164788
32000,131,11855,340571,394128,53557
32000,141,11828,312253,404167,91914
32000,124,11729,339767,456598,116831
32000,235,11675,396996,439588,42592
32000,91,11718,311911,416230,104319
32000,331,11771,393831,407346,13515
32000,270,11702,319697,425407,105710
32000,209,11763,358935,412867,53932
32000,95,11763,348978,399746,50768
33000,110,12150,367550,505035,137485
33000,368,12150,362836,414265,51429
33000,341,12167,364232,439448,75216
33000,412,12208,424362,498420,74058
33000,253,12215,377579,397640,20061
33000,316,12158,352452,534288,181836
33000,196,12193,355053,387166,32113
33000,430,12151,318078,399722,81644
33000,229,12174,342183,401801,59618
33000,52,12184,399013,418009,18996
33000,85,12086,274717,418422,143705
33000,152,12071,340622,471607,130985
33000,333,12159,314637,403156,88519
33000,281,12133,373396,467489,94093
33000,336,12119,345077,414746,69669
33000,195,12087,341553,397304,55751
33000,400,12147,393646,424315,30669
33000,363,12194,363842,466607,102765
33000,401,12118,332156,479366,147210
33000,367,12176,437986,448711,10725
33000,317,12043,309604,424195,114591
33000,407,12101,405958,525157,119199
33000,56,12196,344700,399494,54794
33000,346,12089,352424,440362,87938
33000,188,12111,301457,419309,117852
33000,165,12222,365099,410709,45610
33000,188,12196,338286,397461,59175
33000,95,12221,328333,437327,108994
33000,279,12132,385438,431473,46035
33000,154,12090,472166,472852,686
33000,64,12048,352168,432233,80065
33000,217,12164,350824,454612,103788
33000,406,12144,378590,412306,33716
33000,167,12153,447904,480338,32434
33000,171,12154,353428,503785,150357
33000,414,12076,359091,538051,178960
33000,411,12134,331965,475143,143178
33000,221,12152,357141,392113,34972
33000,179,12081,324917,416960,92043
33000,342,12141,365114,515252,150138
33000,489,12186,391898,444287,52389
33000,183,12138,438773,443665,4892
33000,207,12084,324826,453346,128520
33000,240,12243,384741,529198,144457
33000,236,12157,333523,393614,60091
33000,267,12191,348001,388613,40612
33000,144,12164,394264,432112,37848
33000,597,12123,334852,403765,68913
33000,397,12176,328053,445310,117257
33000,357,12139,359568,392906,33338
34000,286,12431,448091,615696,167605
34000,148,12560,386284,459288,73004
34000,293,12581,309907,520084,210177
34000,136,12454,391930,601044,209114
34000,104,12520,422331,499961,77630
34000,357,12520,343317,435727,92410
34000,79,12576,355428,499567,144139
34000,104,12517,456349,477304,20955
34000,318,12525,383430,410331,26901
34000,166,12645,406325,519249,112924
34000,559,12453,336686,483939,147253
34000,232,12399,307092,481057,173965
34000,215,12535,424134,450011,25877
34000,299,12514,411112,442295,31183
34000,130,12481,396564,467743,71179
34000,118,12495,366825,498154,131329
34000,244,12428,355634,443778,88144
34000,245,12580,422671,485813,63142
34000,319,12517,321606,429420,107814
34000,230,12507,357801,422304,64503
34000,371,12398,433741,454328,20587
34000,443,12590,363015,440560,77545
34000,176,12456,338907,437699,98792
34000,38,12445,351774,502230,150456
34000,62,12512,401798,556821,155023
34000,172,12539,349493,456002,106509
34000,197,12421,332229,404910,72681
34000,469,12448,338139,422984,84845
34000,327,12495,329823,495644,165821
34000,334,12500,337869,439138,101269
34000,347,12624,322472,398109,75637
34000,345,12450,377879,431472,53593
34000,69,12438,425225,503844,78619
34000,130,12564,349313,392480,43167
34000,402,12471,393205,423960,30755
34000,286,12463,326060,462652,136592
34000,40,12458,362352,485150,122798
34000,387,12578,334588,419438,84850
34000,232,12546,362915,507956,145041
34000,185,12476,342539,489793,147254
34000,275,12561,356543,554292,197749
34000,303,12469,356341,426655,70314
34000,256,12574,349764,543263,193499
34000,526,12549,327964,428240,100276
34000,164,12505,334503,418658,84155
34000,243,12489,387043,434869,47826
34000,446,12570,400036,452820,52784
34000,156,12564,393288,515321,122033
34000,89,12488,405663,426942,21279
34000,217,12573,330155,546223,216068
35000,40,12856,330836,460014,129178
35000,144,12804,449218,530680,81462
35000,493,12882,351864,446793,94929
35000,484,12891,420868,491985,71117
35000,105,12879,382882,529492,146610
35000,202,12874,526395,583749,57354
35000,385,12741,322976,436633,113657
35000,279,12892,364553,500808,136255
35000,269,12883,351844,432259,80415
35000,175,12835,358026,504170,146144
35000,314,12902,383293,574960,191667
35000,159,13003,373797,493906,120109
35000,42,12875,318649,428727,110078
35000,123,12799,538549,541483,2934
35000,267,12823,358125,515918,157793
35000,373,12924,379424,436660,57236
35000,351,12921,367926,454635,86709
35000,208,12840,380638,412562,31924
35000,127,12851,361865,484221,122356
35000,352,12777,333371,489237,155866
35000,438,12844,327921,459403,131482
35000,164,12915,354324,522784,168460
35000,174,12871,400394,552155,151761
35000,236,12933,378897,439833,60936
35000,48,12971,335425,450704,115279
35000,97,12858,351684,491935,140251
35000,293,12883,347887,400722,52835
35000,292,12905,384021,512732,128711
35000,99,12858,412829,496878,84049
35000,146,12932,410777,516321,105544
35000,31,12832,408717,465053,56336
35000,194,12866,491702,507947,16245
35000,272,12849,381864,487032,105168
35000,375,12724,346479,432707,86228
35000,353,12831,337470,451334,113864
35000,285,12843,334530,463114,128584
35000,138,12914,386675,427928,41253
35000,258,12884,379626,480204,100578
35000,230,12875,386923,455269,68346
35000,130,12800,380688,467742,87054
35000,212,12900,340865,468667,127802
35000,248,12911,317057,443216,126159
35000,178,12943,360503,488839,128336
35000,165,12851,420331,489818,69487
35000,196,12859,424995,482309,57314
35000,118,12885,333464,435860,102396
35000,65,12902,435986,461066,25080
35000,43,12821,399681,522031,122350
35000,271,12908,384795,490087,105292
35000,236,12917,404722,489158,84436
36000,607,13176,389081,482779,93698
36000,51,13168,415742,477125,61383
36000,420,13237,407658,514066,106408
36000,176,13279,410452,467641,57189
36000,55,13161,449972,453458,3486
36000,315,13205,439803,507052,67249
36000,116,13160,347480,466802,119322
36000,230,13279,412942,470224,57282
36000,273,13273,390732,507608,116876
36000,160,13224,374634,476821,102187
36000,181,13263,405614,640964,235350
36000,382,13222,409497,462839,53342
36000,168,13250,450288,480757,30469
36000,130,13215,348515,458421,109906
36000,343,13272,467819,477588,9769
36000,508,13142,389202,603265,214063
36000,292,13229,390619,440040,49421
36000,223,13271,415292,481254,65962
36000,285,13101,460941,519288,58347
36000,359,13100,372018,523243,151225
36000,101,13230,343441,447108,103667
36000,397,13255,332296,485921,153625
36000,298,13205,371985,549006,177021
36000,288,13233,336509,425006,88497
36000,349,13326,387289,467584,80295
36000,102,13286,415181,475225,60044
36000,226,13210,367319,497374,130055
36000,31,13312,432098,469013,36915
36000,54,13195,461431,486241,24810
36000,239,13190,397431,475256,77825
36000,224,13223,378592,403136,24544
36000,256,13195,345915,411268,65353
36000,356,13296,472144,549479,77335
36000,519,13297,366712,532167,165455
36000,553,13337,461324,511388,50064
36000,151,13219,392828,497053,104225
36000,312,13123,409101,447977,38876
36000,169,13272,380399,415574,35175
36000,148,13203,387756,526315,138559
36000,32,13195,365899,434562,68663
36000,294,13262,320619,447133,126514
36000,259,13317,394003,497990,103987
36000,94,13236,349776,431771,81995
36000,134,13260,393899,447711,53812
36000,99,13216,331943,507691,175748
36000,145,13263,351385,452902,101517
36000,305,13348,380908,500604,119696
36000,197,13279,393813,492505,98692
36000,60,13220,558349,610105,51756
36000,451,13269,373482,450332,76850
37000,144,13616,379879,551011,171132
37000,256,13580,430472,461834,31362
37000,115,13589,421383,449024,27641
37000,202,13564,517934,569595,51661
37000,264,13641,423833,491440,67607
37000,666,13701,474671,490122,15451
37000,342,13605,413940,525169,111229
37000,316,13645,399017,448555,49538
37000,497,13531,364726,655620,290894
37000,340,13759,365438,461182,95744
37000,442,13507,411733,474639,62906
37000,223,13629,446265,585827,139562
37000,124,13547,507845,525373,17528
37000,117,13559,527038,593716,66678
37000,148,13602,377095,562389,185294
37000,341,13541,392917,491356,98439
37000,292,13589,388023,490062,102039
37000,217,13634,347625,507284,159659
37000,171,13616,342497,450673,108176
37000,254,13620,365576,500547,134971
37000,387,13648,397777,440194,42417
37000,232,13657,426510,509482,82972
37000,245,13621,399917,491063,91146
37000,74,13546,415243,448241,32998
37000,131,13696,408600,469694,61094
37000,116,13576,370765,450321,79556
37000,284,13643,372584,572406,199822
37000,152,13609,548024,557213,9189
37000,173,13595,451957,525107,73150
37000,319,13556,435151,481161,46010
37000,41,13544,411257,469512,58255
37000,305,13536,352182,450495,98313
37000,181,13605,404698,460281,55583
37000,263,13537,359786,533099,173313
37000,358,13689,452405,464916,12511
37000,38,13643,428202,486767,58565
37000,218,13802,472018,490076,18058
37000,234,13678,411171,494692,83521
37000,203,13692,483239,588353,105114
37000,156,13597,405832,578345,172513
37000,154,13632,371703,449372,77669
37000,165,13624,360731,484722,123991
37000,253,13580,531448,547461,16013
37000,291,13625,465567,538566,72999
37000,184,13554,398388,526941,128553
37000,349,13569,327552,461512,133960
37000,406,13564,425600,517074,91474
37000,235,13612,431444,573539,142095
37000,343,13585,484568,549254,64686
37000,218,13596,376863,517928,141065
38000,365,13950,398230,481607,83377
38000,116,14031,430343,550725,120382
38000,89,13968,380985,527680,146695
38000,433,13958,420909,579625,158716
38000,151,13927,437229,545470,108241
38000,100,13958,420025,569639,149614
38000,307,13974,439374,512841,73467
38000,139,14001,420791,499712,78921
38000,371,13978,397999,533882,135883
38000,292,14069,403496,489649,86153
38000,72,13958,420364,489065,68701
38000,183,13969,474349,545500,71151
38000,182,14027,428410,549861,121451
38000,291,13917,423205,440864,17659
38000,95,13903,401848,510658,108810
38000,116,14072,341440,471210,129770
38000,325,14028,413957,643955,229998
38000,176,14053,399116,460867,61751
38000,262,14022,435360,470658,35298
38000,346,13847,359985,452775,92790
38000,328,13952,501252,548374,47122
38000,476,13969,400460,499729,99269
38000,163,14022,398653,535773,137120
38000,219,13868,548038,576175,28137
38000,261,14063,406610,515389,108779
38000,415,13950,385817,669677,283860
38000,221,14021,438195,503218,65023
38000,510,13913,390067,590499,200432
38000,218,13979,448293,473428,25135
38000,259,13990,397485,510460,112975
38000,100,13914,429714,495066,65352
38000,95,14020,510961,563033,52072
38000,87,13971,416731,499966,83235
38000,648,14003,437921,489908,51987
38000,157,14009,427978,486618,58640
38000,225,13981,432476,522887,90411
38000,513,13942,378396,487692,109296
38000,270,13939,388187,461952,73765
38000,324,14045,528254,581285,53031
38000,133,14013,431725,560041,128316
38000,136,14030,408062,474273,66211
38000,403,14009,503364,508297,4933
38000,336,13885,356229,420559,64330
38000,185,13976,379327,579631,200304
38000,253,13987,443885,501726,57841
38000,346,13970,421286,447614,26328
38000,51,14027,526934,571680,44746
38000,303,13996,363559,446331,82772
38000,227,13929,383878,536312,152434
38000,303,13974,369062,468393,99331
39000,351,14377,402503,495612,93109
39000,124,14299,535531,551758,16227
39000,190,14278,375450,544748,169298
39000,139,14390,373999,536526,162527
39000,177,14346,487424,503560,16136
39000,284,14441,392899,536505,143606
39000,95,14278,430660,546529,115869
39000,269,14334,459874,481668,21794
39000,204,14391,423576,506903,83327
39000,127,14253,417841,472201,54360
39000,207,14427,369487,483126,113639
39000,127,14361,487738,548940,61202
39000,75,14357,399614,539886,140272
39000,178,14310,388867,465878,77011
39000,399,14397,437991,556297,118306
39000,38,14365,448753,462824,14071
39000,234,14406,511260,547861,36601
39000,300,14450,414974,543651,128677
39000,488,14483,484600,717213,232613
39000,428,14349,448622,558856,110234
39000,231,14321,459247,579644,120397
39000,366,14328,379815,483551,103736
39000,99,14360,448943,506575,57632
39000,171,14346,383265,468533,85268
39000,211,14343,415643,598927,183284
39000,122,14307,509919,542785,32866
39000,242,14379,359042,638646,279604
39000,118,14294,441915,569533,127618
39000,321,14339,420708,583404,162696
39000,258,14349,384383,578546,194163
39000,360,14316,467561,641755,174194
39000,141,14426,386937,548246,161309
39000,313,14320,414618,503935,89317
39000,246,14420,394376,564179,169803
39000,412,14369,422083,489312,67229
39000,437,14201,390867,598912,208045
39000,320,14375,481273,564437,83164
39000,227,14264,448166,570933,122767
39000,126,14353,439562,512396,72834
39000,41,14373,402402,559242,156840
39000,76,14328,407127,539051,131924
39000,332,14402,443849,498253,54404
39000,359,14339,417678,500095,82417
39000,190,14410,420006,535351,115345
39000,296,14336,625390,663875,38485
39000,508,14368,450582,542479,91897
39000,290,14359,509798,582977,73179
39000,146,14325,408689,608438,199749
39000,149,14330,467823,481561,13738
39000,272,14203,394919,510637,115718
40000,173,14695,558415,588677,30262
40000,105,14815,601419,630574,29155
40000,101,14762,572257,640749,68492
40000,373,14705,428345,495417,67072
40000,33,14699,426218,504547,78329
40000,319,14739,403223,551738,148515
40000,413,14580,450016,533686,83670
40000,182,14660,498259,547070,48811
40000,314,14638,512780,541404,28624
40000,360,14647,407156,583121,175965
40000,285,14736,388431,616792,228361
40000,422,14602,475242,502935,27693
40000,186,14676,400723,550050,149327
40000,486,14691,440527,510578,70051
40000,277,14697,481560,622366,140806
40000,162,14725,361241,475914,114673
40000,300,14696,386297,525190,138893
40000,164,14655,408490,491557,83067
40000,570,14790,602388,603137,749
40000,169,14736,426446,519933,93487
40000,285,14824,464910,504546,39636
40000,419,14656,580968,585623,4655
40000,240,14736,430235,521480,91245
40000,85,14761,427298,525830,98532
40000,399,14689,418306,540124,121818
40000,517,14539,397963,574694,176731
40000,163,14697,453834,534271,80437
40000,408,14735,432817,510717,77900
40000,162,14717,435495,525942,90447
40000,55,14648,418541,536309,117768
40000,273,14807,417536,636893,219357
40000,329,14698,394870,459815,64945
40000,96,14678,435619,522071,86452
40000,221,14675,495936,572179,76243
40000,249,14751,450793,517747,66954
40000,396,14641,438244,501088,62844
40000,261,14752,460306,642444,182138
40000,57,14689,395869,586041,190172
40000,42,14702,427013,623198,196185
40000,227,14756,454607,518304,63697
40000,96,14715,407223,593934,186711
40000,242,14715,534356,612632,78276
40000,408,14809,436480,476139,39659
40000,312,14641,462551,536113,73562
40000,247,14681,485123,604866,119743
40000,320,14625,548804,578850,30046
40000,133,14687,432228,494607,62379
40000,318,14691,455106,621762,166656
40000,260,14675,429139,531740,102601
40000,163,14685,409975,557248,147273
41000,225,15039,476604,577658,101054
41000,84,15152,471409,509901,38492
41000,92,15089,437224,523715,86491
41000,424,15105,515591,639810,124219
41000,187,15207,460216,568641,108425
41000,380,15137,396203,625952,229749
41000,256,15154,426576,487294,60718
41000,236,15139,497129,652515,155386
41000,274,15050,418471,563683,145212
41000,93,15065,508462,559268,50806
41000,33,15001,453453,480676,27223
41000,307,15142,496822,520147,23325
41000,358,15048,479040,591632,112592
41000,194,15107,431149,598213,167064
41000,112,15013,439255,553099,113844
41000,545,15181,468720,594747,126027
41000,264,15088,468537,513234,44697
41000,31,15129,530541,577052,46511
41000,126,15196,470919,475719,4800
41000,340,15121,615521,630921,15400
41000,98,15154,504547,594596,90049
41000,247,14979,522474,612753,90279
41000,489,15111,454950,519062,64112
41000,256,15046,435193,533576,98383
41000,98,15015,402830,478159,75329
41000,341,14945,476987,535765,58778
41000,304,15112,403583,472650,69067
41000,98,15077,474545,511180,36635
41000,467,15058,457096,524169,67073
41000,577,15013,502758,626271,123513
41000,280,15146,397523,518078,120555
41000,345,15150,422646,559879,137233
41000,264,15122,464392,602911,138519
41000,509,15096,449008,523479,74471
41000,298,15015,437757,464772,27015
41000,247,14988,424505,542189,117684
41000,291,15071,464030,677434,213404
41000,289,15116,571213,573717,2504
41000,475,15109,461771,556240,94469
41000,256,15074,405289,558370,153081
41000,448,15030,464042,592510,128468
41000,292,15028,455891,513298,57407
41000,273,15099,513094,759384,246290
41000,227,15023,430600,598104,167504
41000,79,14981,424111,580540,156429
41000,123,15147,463662,530153,66491
41000,154,15150,420344,633696,213352
41000,279,15228,435375,607073,171698
41000,53,14965,448844,578341,129497
41000,588,15129,410336,494370,84034
42000,262,15629,450383,711942,261559
42000,188,15544,521977,548019,26042
42000,124,15500,460741,548198,87457
42000,86,15382,582097,731967,149870
42000,273,15465,534526,674311,139785
42000,150,15471,386623,603777,217154
42000,98,15538,503736,534014,30278
42000,390,15463,570101,607234,37133
42000,97,15305,508587,545885,37298
42000,380,15409,531989,590698,58709
42000,150,15373,432772,530274,97502
42000,232,15351,496757,644651,147894
42000,454,15360,409997,587074,177077
42000,107,15456,408111,516948,108837
42000,410,15462,465157,661217,196060
42000,231,15378,450619,545873,95254
42000,202,15350,538115,572255,34140
42000,30,15425,474029,603763,129734
42000,58,15432,410985,511386,100401
42000,222,15513,462289,532413,70124
42000,368,15343,563843,586713,22870
42000,413,15421,516914,580207,63293
42000,313,15413,393871,519223,125352
42000,252,15380,513644,601037,87393
42000,317,15460,483208,518914,35706
42000,98,15459,461707,530474,68767
42000,192,15442,415758,573193,157435
42000,118,15491,494949,561878,66929
42000,532,15466,400737,545825,145088
42000,162,15495,495527,722161,226634
42000,293,15412,450905,589946,139041
42000,228,15425,564643,777922,213279
42000,250,15390,472693,567371,94678
42000,239,15392,448937,582594,133657
42000,238,15468,438117,517262,79145
42000,231,15481,464773,552193,87420
42000,463,15491,421317,601567,180250
42000,78,15524,456231,572439,116208
42000,330,15399,392589,541869,149280
42000,294,15462,437386,512406,75020
42000,169,15402,588721,605701,16980
42000,216,15477,458758,669032,210274
42000,187,15378,427942,513385,85443
42000,335,15336,502012,615985,113973
42000,131,15432,518909,618826,99917
42000,201,15457,469064,537779,68715
42000,319,15532,517979,546778,28799
42000,332,15451,398012,530819,132807
42000,271,15405,447807,487546,39739
42000,125,15367,485931,546356,60425
43000,130,15880,481492,595915,114423
43000,86,15908,439148,619297,180149
43000,381,15851,426120,616433,190313
43000,424,15847,491934,671005,179071
43000,128,15830,405182,559698,154516
43000,230,15966,485947,565132,79185
43000,372,15855,551469,569858,18389
43000,436,15779,405204,506239,101035
43000,165,15865,426812,564409,137597
43000,155,15835,429765,604673,174908
43000,171,15833,480911,566718,85807
43000,103,15805,472367,590368,118001
43000,332,15794,453161,540818,87657
43000,288,15754,448409,549372,100963
43000,278,15786,556673,577320,20647
43000,59,15844,482672,543662,60990
43000,197,15850,424969,482084,57115
43000,188,15853,459928,534176,74248
43000,224,15815,492293,604265,111972
43000,162,15871,440712,596993,156281
43000,149,15725,523643,630444,106801
43000,252,15770,490413,588899,98486
43000,676,15805,473827,667190,193363
43000,439,15843,411014,524689,113675
43000,224,15718,415152,580368,165216
43000,295,15795,475810,501542,25732
43000,433,15848,463455,558281,94826
43000,399,15750,569053,605309,36256
43000,37,15783,468781,652547,183766
43000,382,15830,502977,526852,23875
43000,266,15776,467139,561295,94156
43000,138,15697,545200,665244,120044
43000,153,15800,460273,540006,79733
43000,206,15720,450834,597076,146242
43000,307,15907,472585,499669,27084
43000,302,15829,417613,476452,58839
43000,584,15817,452413,555705,103292
43000,215,15902,470622,594793,124171
43000,142,15845,543842,591684,47842
43000,175,15920,464481,655344,190863
43000,105,15855,385971,589364,203393
43000,194,15817,509217,784274,275057
43000,198,15708,426793,559787,132994
43000,94,15902,406619,582193,175574
43000,93,15794,391415,512807,121392
43000,415,15737,457684,526256,68572
43000,87,15764,631041,646350,15309
43000,202,15873,489048,567189,78141
43000,286,15770,616359,620233,3874
43000,378,15755,521212,625679,104467
44000,301,16244,524624,560534,35910
44000,248,16155,443850,705792,261942
44000,241,16153,412272,611413,199141
44000,228,16160,443486,557478,113992
44000,133,16053,518654,597437,78783
44000,40,16142,431926,559430,127504
44000,380,16101,436877,592212,155335
44000,250,16203,416188,628979,212791
44000,155,16316,497500,549661,52161
44000,224,16096,460063,577802,117739
44000,216,16148,512529,699068,186539
44000,114,16022,481324,513659,32335
44000,138,16195,463400,580797,117397
44000,162,16091,483217,681048,197831
44000,337,16090,458924,694006,235082
44000,261,16137,604552,723397,118845
44000,106,16240,664783,690832,26049
44000,201,16266,506338,597023,90685
44000,235,16261,482981,532072,49091
44000,139,16060,483627,599028,115401
44000,85,16146,526985,587512,60527
44000,210,16220,423643,673191,249548
44000,233,16186,525323,632343,107020
44000,390,16323,473732,579811,106079
44000,281,16219,489999,599565,109566
44000,179,16189,459762,656233,196471
44000,106,16165,460749,640792,180043
44000,368,16158,516439,553647,37208
44000,61,16087,461467,614828,153361
44000,344,16285,522762,630128,107366
44000,272,16149,472002,576936,104934
44000,56,16156,495520,800566,305046
44000,160,16187,436551,565912,129361
44000,200,16241,517912,572270,54358
44000,446,16202,535814,673275,137461
44000,337,16128,532620,580668,48048
44000,459,16164,625333,651564,26231
44000,368,16231,494667,613962,119295
44000,359,16205,495407,612041,116634
44000,223,16142,501392,624002,122610
44000,269,16199,486639,586094,99455
44000,154,16296,528353,579108,50755
44000,173,16180,477279,633920,156641
44000,363,16134,489271,577836,88565
44000,371,16134,526188,726627,200439
44000,369,16279,450089,528714,78625
44000,730,16250,465136,631845,166709
44000,181,16251,511657,576313,64656
44000,31,16161,515698,575925,60227
44000,288,16113,435295,556442,121147
45000,254,16727,507139,629590,122451
45000,137,16578,503981,597876,93895
45000,149,16552,560212,618536,58324
45000,125,16569,535888,626757,90869
45000,492,16580,520588,694041,173453
45000,297,16620,517518,616813,99295
45000,489,16570,461625,590308,128683
45000,201,16603,482918,616701,133783
45000,179,16478,471531,548948,77417
45000,396,16521,493563,612218,118655
45000,101,16509,480600,577287,96687
45000,276,16623,483239,612484,129245
45000,202,16593,549962,666620,116658
45000,387,16604,518481,623665,105184
45000,15,16647,463084,762858,299774
45000,91,16574,534983,603484,68501
45000,89,16595,485029,622302,137273
45000,229,16484,495555,595168,99613
45000,140,16731,484309,550469,66160
45000,169,16466,561846,566946,5100
45000,81,16429,463182,606451,143269
45000,259,16546,544898,609055,64157
45000,213,16484,481092,658199,177107
45000,41,16488,502159,569739,67580
45000,475,16448,482468,594765,112297
45000,145,16518,493815,627712,133897
45000,276,16486,424074,626995,202921
45000,277,16649,428239,597939,169700
45000,281,16552,469057,541247,72190
45000,92,16508,556238,596246,40008
45000,444,16592,469928,620367,150439
45000,314,16541,460099,543310,83211
45000,222,16588,541935,800455,258520
45000,281,16540,505433,540070,34637
45000,289,16561,463512,618575,155063
45000,488,16623,514573,621804,107231
45000,231,16529,491668,593251,101583
45000,275,16519,479472,558834,79362
45000,346,16644,538002,715752,177750
45000,412,16650,480444,653728,173284
45000,25,16575,574334,671864,97530
45000,47,16476,471223,639610,168387
45000,199,16619,478617,609852,131235
45000,481,16404,468341,598378,130037
45000,417,16535,500621,613108,112487
45000,184,16682,480665,587980,107315
45000,187,16538,542290,594729,52439
45000,141,16562,513367,641822,128455
45000,256,16515,576630,660199,83569
45000,669,16585,463892,566090,102198
46000,69,16945,498182,734776,236594
46000,49,16861,553001,616548,63547
46000,301,16965,467754,658234,190480
46000,166,16996,566332,589050,22718
46000,273,16980,439165,579979,140814
46000,160,16919,457080,591451,134371
46000,189,16907,520823,761135,240312
46000,198,16975,607648,624504,16856
46000,303,16956,543043,639458,96415
46000,154,16943,569094,619117,50023
46000,202,16966,468997,782873,313876
46000,458,16916,482461,623514,141053
46000,417,16880,491208,581678,90470
46000,419,16844,570855,714553,143698
46000,416,16971,694938,716374,21436
46000,618,16942,620164,693449,73285
46000,46,16804,487666,624362,136696
46000,93,16887,530604,578646,48042
46000,373,16856,445954,615832,169878
46000,154,16935,499184,578683,79499
46000,317,16887,534537,618385,83848
46000,494,16965,438414,543691,105277
46000,397,16822,470942,593279,122337
46000,298,17028,577676,607276,29600
46000,335,16897,496980,733598,236618
46000,336,16926,574746,631813,57067
46000,126,16872,533324,575280,41956
46000,422,16996,492926,637965,145039
46000,334,16935,499551,569208,69657
46000,402,16974,498843,620128,121285
46000,302,17015,444929,580792,135863
46000,145,16938,536402,639382,102980
46000,146,16844,525325,614840,89515
46000,194,16909,482283,662517,180234
46000,168,16871,422351,657504,235153
46000,223,16913,485360,653657,168297
46000,103,17004,493210,570494,77284
46000,83,16858,453109,548975,95866
46000,278,16990,473260,626307,153047
46000,172,16983,526432,562498,36066
46000,433,16879,598669,643559,44890
46000,204,16935,483409,592627,109218
46000,212,16962,536853,695023,158170
46000,620,16827,560138,612681,52543
46000,225,16843,519532,681109,161577
46000,238,16872,571219,579341,8122
46000,324,16993,489950,548228,58278
46000,34,17005,550525,664406,113881
46000,388,16945,532027,631988,99961
46000,163,16928,504915,684202,179287
47000,309,17265,498096,588209,90113
47000,204,17265,499468,669088,169620
47000,243,17160,538878,744392,205514
47000,58,17371,644043,686661,42618
47000,327,17265,552399,574825,22426
47000,273,17137,505827,686731,180904
47000,392,17340,509407,804762,295355
47000,236,17252,563325,672085,108760
47000,436,17123,519389,676269,156880
47000,176,17316,627652,691192,63540
47000,292,17163,575317,766764,191447
47000,143,17195,526020,676413,150393
47000,137,17324,459917,704510,244593
47000,413,17231,582664,609418,26754
47000,262,17211,524057,640589,116532
47000,147,17296,468905,531013,62108
47000,207,17407,554607,709685,155078
47000,244,17319,439490,641796,202306
47000,484,17291,486154,580791,94637
47000,508,17379,588856,843128,254272
47000,272,17292,517732,647951,130219
47000,309,17350,785141,845393,60252
47000,292,17355,518904,708040,189136
47000,353,17394,533187,662637,129450
47000,196,17432,530630,832404,301774
47000,421,17246,518858,873532,354674
47000,227,17208,554038,626695,72657
47000,161,17352,654540,674580,20040
47000,59,17344,532564,696768,164204
47000,219,17265,472996,731382,258386
47000,325,17280,560608,593988,33380
47000,176,17373,623032,627814,4782
47000,263,17271,500315,606636,106321
47000,315,17349,508898,689611,180713
47000,357,17260,512860,619141,106281
47000,166,17395,499113,655125,156012
47000,261,17124,525410,653742,128332
47000,114,17316,538945,627715,88770
47000,251,17191,507399,736729,229330
47000,450,17313,611873,632524,20651
47000,465,17318,767813,767844,31
47000,231,17267,512522,677452,164930
47000,228,17268,561444,620480,59036
47000,41,17384,543905,666826,122921
47000,183,17272,494707,619050,124343
47000,325,17372,541437,677210,135773
47000,433,17327,498447,696662,198215
47000,253,17343,478745,740005,261260
47000,232,17249,533718,720779,187061
47000,329,17319,501423,601082,99659
48000,235,17732,661250,723672,62422
48000,240,17639,465068,621373,156305
48000,211,17630,464980,646286,181306
48000,328,17668,537329,581456,44127
48000,365,17711,516314,640639,124325
48000,328,17620,484248,555669,71421
48000,706,17638,593261,640746,47485
48000,287,17733,519061,727765,208704
48000,312,17771,556878,606284,49406
48000,470,17606,484422,800478,316056
48000,140,17562,611794,699283,87489
48000,377,17681,530180,709081,178901
48000,575,17593,550922,615020,64098
48000,282,17601,465617,715471,249854
48000,136,17713,808068,877282,69214
48000,157,17740,579935,711750,131815
48000,187,17623,582553,613463,30910
48000,48,17576,582613,658483,75870
48000,295,17720,589492,709991,120499
48000,108,17660,571814,609233,37419
48000,325,17753,569477,706614,137137
48000,90,17658,620699,723120,102421
48000,511,17557,488395,662964,174569
48000,69,17608,579343,618155,38812
48000,314,17721,586854,663841,76987
48000,145,17656,571400,673142,101742
48000,288,17825,613219,649391,36172
48000,359,17746,458549,683244,224695
48000,924,17495,498262,650673,152411
48000,198,17723,608718,744112,135394
48000,860,17657,513025,627194,114169
48000,405,17659,516408,727934,211526
48000,92,17674,648105,683696,35591
48000,34,17609,630973,654106,23133
48000,96,17582,511864,668660,156796
48000,399,17698,482568,788790,306222
48000,143,17663,571865,651937,80072
48000,325,17656,649081,685302,36221
48000,199,17729,528994,650959,121965
48000,368,17502,474127,673848,199721
48000,259,17749,511739,774643,262904
48000,447,17766,605852,885307,279455
48000,261,17617,541685,586678,44993
48000,160,17667,613840,678008,64168
48000,143,17646,558281,647014,88733
48000,208,17670,488507,592156,103649
48000,184,17550,488749,666512,177763
48000,468,17660,478334,639127,160793
48000,122,17687,461902,637211,175309
48000,411,17620,617495,666007,48512
49000,484,17842,560031,718576,158545
49000,228,18122,509059,859687,350628
49000,249,18042,610367,682248,71881
49000,78,18015,542891,638913,96022
49000,633,17974,582212,599756,17544
49000,163,18081,489698,634197,144499
49000,458,17940,527363,676158,148795
49000,293,17944,575716,708210,132494
49000,170,17969,514559,616828,102269
49000,50,18058,518248,613671,95423
49000,315,18032,598833,716982,118149
49000,301,17974,645591,793362,147771
49000,285,17959,606483,629671,23188
49000,272,18091,636202,802559,166357
49000,97,18071,598542,700074,101532
49000,242,18041,520838,632466,111628
49000,196,18035,480164,732973,252809
49000,169,17882,511043,818866,307823
49000,189,18055,542576,690933,148357
49000,375,18028,467697,844902,377205
49000,619,18146,581095,713541,132446
49000,327,17995,569637,679645,110008
49000,601,17955,573077,658311,85234
49000,296,18000,593117,664064,70947
49000,354,18107,575598,628642,53044
49000,437,18053,564595,638770,74175
49000,218,18046,778443,800764,22321
49000,427,18053,563207,645510,82303
49000,602,17946,607534,806967,199433
49000,90,18061,529292,739306,210014
49000,560,18126,519878,626048,106170
49000,257,17945,482040,642919,160879
49000,134,18067,568267,688812,120545
49000,354,18052,741048,743484,2436
49000,43,18021,572967,673060,100093
49000,222,17986,557730,770772,213042
49000,69,17907,504040,590912,86872
49000,41,17940,590987,686657,95670
49000,319,18044,572945,634796,61851
49000,69,18046,591422,669178,77756
49000,467,17976,455627,587495,131868
49000,104,17963,506007,624979,118972
49000,333,18164,642145,689801,47656
49000,521,18032,466990,716987,249997
49000,169,18031,615294,673455,58161
49000,278,17935,556836,730639,173803
49000,152,18031,546170,646977,100807
49000,318,18093,715745,755006,39261
49000,205,18000,613792,700119,86327
49000,191,18334,489694,696099,206405
50000,456,18450,575443,774673,199230
50000,294,18352,515103,696363,181260
50000,222,18326,647286,739541,92255
50000,431,18366,505593,676442,170849
50000,423,18371,548402,698791,150389
50000,177,18414,531263,649172,117909
50000,285,18200,563493,743280,179787
50000,306,18216,534196,766832,232636
50000,373,18377,565629,687527,121898
50000,184,18472,537969,636229,98260
50000,170,18415,502273,617139,114866
50000,434,18313,553543,705018,151475
50000,117,18382,581987,748143,166156
50000,125,18409,522109,609313,87204
50000,346,18386,545499,722129,176630
50000,254,18411,640257,673900,33643
50000,228,18412,769280,862294,93014
50000,258,18399,531820,619458,87638
50000,345,18432,565750,670179,104429
50000,435,18357,467859,619873,152014
50000,258,18370,549643,691994,142351
50000,177,18428,594182,665501,71319
50000,361,18360,514422,834426,320004
50000,639,18449,507919,662427,154508
50000,261,18312,608851,641325,32474
50000,176,18469,600325,654916,54591
50000,175,18246,570121,645626,75505
50000,81,18326,542954,639841,96887
50000,302,18282,669147,805655,136508
50000,372,18293,519204,701262,182058
50000,211,18507,770863,788263,17400
50000,53,18276,533761,807720,273959
50000,266,18359,725088,729125,4037
50000,71,18416,542751,657286,114535
50000,401,18451,543954,702940,158986
50000,307,18387,499836,642916,143080
50000,324,18412,614163,681058,66895
50000,383,18324,534441,728710,194269
50000,191,18326,721377,761525,40148
50000,480,18508,536493,647864,111371
50000,97,18479,497758,677445,179687
50000,431,18491,630126,650760,20634
50000,123,18453,537713,643011,105298
50000,456,18468,505395,725570,220175
50000,547,18463,556881,631233,74352
50000,127,18435,521822,685762,163940
50000,190,18379,564680,791493,226813
50000,408,18401,565171,623812,58641
50000,393,18398,599033,720432,121399
50000,352,18360,517342,600870,83528
51000,234,18895,598983,627409,28426
51000,210,18737,503557,730151,226594
51000,133,18757,546433,659365,112932
51000,90,18870,480122,641575,161453
51000,128,18719,552434,630115,77681
51000,333,18687,552344,632325,79981
51000,384,18739,618495,861162,242667
51000,202,18728,453548,878369,424821
51000,283,18847,650730,661111,10381
51000,324,18800,558000,697544,139544
51000,484,18888,524621,642521,117900
51000,230,18742,567426,726561,159135
51000,367,18745,630847,755557,124710
51000,208,18670,616601,712797,96196
51000,181,18756,592889,665991,73102
51000,184,18689,546558,734184,187626
51000,273,18702,718003,827323,109320
51000,108,18879,622091,766309,144218
51000,330,18851,507966,660498,152532
51000,237,18806,542621,690369,147748
51000,100,18833,577267,700270,123003
51000,375,18863,528640,645568,116928
51000,516,18705,554910,661528,106618
51000,71,18762,553574,679882,126308
51000,306,18884,643455,751408,107953
51000,304,18691,525250,685755,160505
51000,184,18760,585565,707672,122107
51000,330,18673,558278,734770,176492
51000,565,18867,493297,602892,109595
51000,72,18766,579394,667992,88598
51000,293,18785,562052,808335,246283
51000,498,18850,604324,664320,59996
51000,337,18697,576668,646883,70215
51000,393,18758,710458,782470,72012
51000,77,18755,547824,728375,180551
51000,588,18899,646789,836726,189937
51000,424,18717,606276,762802,156526
51000,290,18688,497166,649535,152369
51000,154,18752,616446,654185,37739
51000,293,18740,511160,606571,95411
51000,247,18615,512966,844279,331313
51000,318,18702,492130,688382,196252
51000,170,18784,532181,624977,92796
51000,171,18701,502102,708760,206658
51000,323,18784,573577,679798,106221
51000,315,18685,740287,768003,27716
51000,45,18628,800939,844062,43123
51000,610,18792,575291,700858,125567
51000,304,18708,640880,799101,158221
51000,214,18712,624911,654220,29309
52000,217,19203,503797,779686,275889
52000,145,19109,655588,657360,1772
52000,432,19087,594027,699488,105461
52000,329,19097,556104,654067,97963
52000,399,19032,615525,691881,76356
52000,230,19090,555376,750252,194876
52000,243,19103,615692,918002,302310
52000,253,19080,575611,717008,141397
52000,170,19227,552789,739607,186818
52000,64,19220,552290,668248,115958
52000,313,19137,531941,640111,108170
52000,57,19187,510899,645638,134739
52000,84,19044,662810,745827,83017
52000,378,19173,562060,649978,87918
52000,238,19076,569986,822581,252595
52000,94,19033,599232,733755,134523
52000,224,19071,741099,848505,107406
52000,104,19146,592726,987903,395177
52000,190,19136,548582,731098,182516
52000,143,19090,593594,732276,138682
52000,98,19162,621487,724478,102991
52000,288,19213,615287,684190,68903
52000,294,19052,642407,794416,152009
52000,414,19157,609011,846014,237003
52000,205,19077,604630,649468,44838
52000,169,19170,493632,665957,172325
52000,279,19002,589683,660363,70680
52000,434,19166,543801,702941,159140
52000,166,19218,561009,732230,171221
52000,270,19086,597046,755552,158506
52000,114,19239,576794,634909,58115
52000,134,19141,623299,747824,124525
52000,697,19188,708985,760077,51092
52000,552,19233,601106,708064,106958
52000,462,19172,557988,771382,213394
52000,154,19108,525355,878115,352760
52000,227,19148,544562,752364,207802
52000,346,19167,558728,740206,181478
52000,292,19140,536445,799301,262856
52000,292,19211,582048,701705,119657
52000,192,19104,673663,819764,146101
52000,111,19120,632117,649544,17427
52000,88,19096,537227,738751,201524
52000,166,19118,624278,771582,147304
52000,202,19123,678712,724450,45738
52000,414,19040,524697,675524,150827
52000,510,19084,516666,697630,180964
52000,395,19082,656448,662769,6321
52000,346,19082,672262,745963,73701
52000,406,19121,529461,676240,146779
53000,533,19484,651009,827938,176929
53000,460,19463,594172,716262,122090
53000,364,19382,737325,756948,19623
53000,286,19297,675389,715536,40147
53000,461,19580,555581,773327,217746
53000,153,19518,562613,683518,120905
53000,137,19465,552023,772163,220140
53000,296,19417,652628,823891,171263
53000,637,19539,556763,772542,215779
53000,412,19442,511603,762533,250930
53000,462,19485,596914,654439,57525
53000,174,19609,616763,771929,155166
53000,194,19497,592604,741557,148953
53000,208,19638,647078,763660,116582
53000,19,19497,784260,844985,60725
53000,251,19459,667303,848123,180820
53000,307,19519,618632,724062,105430
53000,236,19512,581135,713731,132596
53000,181,19437,641224,912501,271277
53000,345,19484,544322,698315,153993
53000,77,19529,555847,756664,200817
53000,275,19446,715978,724734,8756
53000,339,19495,681332,792316,110984
53000,218,19440,518973,775330,256357
53000,512,19397,531764,682322,150558
53000,95,19534,541910,781527,239617
53000,159,19543,624821,659896,35075
53000,172,19511,548454,854167,305713
53000,626,19557,546978,720682,173704
53000,279,19527,586177,823083,236906
53000,267,19368,561688,1030002,468314
53000,87,19503,624655,711339,86684
53000,83,19584,654821,679138,24317
53000,373,19490,709732,815638,105906
53000,164,19553,734547,798370,63823
53000,511,19514,661476,867383,205907
53000,297,19453,587742,738405,150663
53000,48,19519,542981,855915,312934
53000,115,19505,759614,799051,39437
53000,329,19621,603126,773059,169933
53000,190,19458,632351,708598,76247
53000,172,19685,591875,768491,176616
53000,715,19400,626799,741529,114730
53000,858,19534,649568,723460,73892
53000,186,19497,655115,958912,303797
53000,464,19508,621080,677727,56647
53000,275,19526,574981,840633,265652
53000,443,19437,626996,752484,125488
53000,141,19446,550080,751988,201908
53000,523,19520,665479,779071,113592
54000,41,19701,652680,704395,51715
54000,55,19820,551643,697003,145360
54000,143,19911,635080,721542,86462
54000,919,19869,608776,777947,169171
54000,348,19847,628446,801035,172589
54000,290,19851,656536,737058,80522
54000,455,19816,642795,695297,52502
54000,461,19774,529773,868351,338578
54000,115,19805,572768,804607,231839
54000,642,19773,535704,695136,159432
54000,340,19818,598324,754009,155685
54000,250,19743,561547,655725,94178
54000,365,19917,583628,751256,167628
54000,578,19920,519730,773713,253983
54000,138,19883,600251,680232,79981
54000,461,19845,533144,703590,170446
54000,262,19885,655552,741909,86357
54000,79,19974,606318,936767,330449
54000,222,19886,787896,797630,9734
54000,377,19799,653047,721923,68876
54000,357,19902,513858,620587,106729
54000,376,19898,538977,820217,281240
54000,157,19864,599172,768020,168848
54000,278,19834,660692,703514,42822
54000,219,19840,615646,720033,104387
54000,440,19681,632194,680152,47958
54000,301,19866,645677,946174,300497
54000,225,19886,770492,814727,44235
54000,100,19911,782629,859281,76652
54000,208,19960,587247,655890,68643
54000,327,19816,544309,679848,135539
54000,218,19711,638557,718885,80328
54000,275,19805,723986,737613,13627
54000,33,19857,553061,703529,150468
54000,345,19892,557801,766681,208880
54000,255,19901,511087,672162,161075
54000,70,19883,494971,717348,222377
54000,530,19907,605295,706230,100935
54000,495,19888,676869,726148,49279
54000,132,19868,728377,859319,130942
54000,290,19809,615683,740106,124423
54000,245,19977,694505,740612,46107
54000,76,19948,647949,729177,81228
54000,388,19840,512825,795673,282848
54000,203,19681,706228,824590,118362
54000,373,19772,521665,655057,133392
54000,84,19925,560552,715099,154547
54000,251,19928,626675,776565,149890
54000,319,19912,746385,807660,61275
54000,172,19796,576798,772149,195351
55000,492,20260,600323,829717,229394
55000,193,20175,703806,794311,90505
55000,288,20199,658518,849304,190786
55000,569,20244,694434,791639,97205
55000,371,20087,561291,776002,214711
55000,491,20144,680597,1005241,324644
55000,291,20275,560373,1049524,489151
55000,128,20202,682570,759293,76723
55000,489,20269,688131,816433,128302
55000,255,20368,575024,733089,158065
55000,230,20358,622297,775921,153624
55000,234,20263,672642,790954,118312
55000,251,20200,606043,791618,185575
55000,217,20294,730505,769133,38628
55000,159,20367,685742,728147,42405
55000,558,20241,553379,884501,331122
55000,339,20262,553575,743297,189722
55000,329,20333,520652,698453,177801
55000,369,20263,608479,734914,126435
55000,577,20220,553178,741020,187842
55000,392,20283,516996,823765,306769
55000,68,20034,651551,924303,272752
55000,263,20100,666833,786410,119577
55000,453,20151,614603,838889,224286
55000,312,20160,899495,902904,3409
55000,538,20189,621327,725653,104326
55000,457,20204,686368,764058,77690
55000,203,20208,640860,685419,44559
55000,355,20171,588088,915641,327553
55000,185,20112,660107,823224,163117
55000,219,20221,849788,1002018,152230
55000,654,20226,558726,741085,182359
55000,360,20245,652134,777094,124960
55000,277,20165,575416,693995,118579
55000,747,20287,649198,818260,169062
55000,357,20236,630441,675215,44774
55000,361,20199,731791,754048,22257
55000,290,20170,572188,654876,82688
55000,228,20237,573574,762277,188703
55000,242,20261,594298,759783,165485
55000,245,20195,606444,685685,79241
55000,397,20325,654802,767836,113034
55000,211,20267,673567,838098,164531
55000,581,20200,595275,848201,252926
55000,227,20127,763218,841860,78642
55000,146,20105,540567,734603,194036
55000,249,20235,634474,681703,47229
55000,280,20294,659536,727547,68011
55000,154,20188,705087,756811,51724
55000,181,20087,551341,782486,231145
56000,233,20546,640786,760903,120117
56000,320,20519,614743,716869,102126
56000,514,20573,605314,849575,244261
56000,426,20628,604647,737551,132904
56000,203,20623,578811,719947,141136
56000,396,20472,574359,788307,213948
56000,355,20596,613078,774876,161798
56000,366,20454,702909,873146,170237
56000,324,20638,582270,918365,336095
56000,270,20520,708098,902641,194543
56000,205,20555,592567,746023,153456
56000,384,20495,638362,851138,212776
56000,322,20545,578574,999910,421336
56000,296,20595,591814,812708,220894
56000,483,20606,712961,771646,58685
56000,274,20517,770495,791780,21285
56000,593,20531,560397,724231,163834
56000,242,20499,780082,794840,14758
56000,141,20567,719144,1013684,294540
56000,185,20513,606541,872534,265993
56000,259,20635,767276,815963,48687
56000,238,20591,640919,827327,186408
56000,523,20591,728215,812809,84594
56000,408,20624,562995,840207,277212
56000,261,20581,517073,730433,213360
56000,285,20611,564283,802332,238049
56000,102,20697,585243,701822,116579
56000,152,20599,851824,888322,36498
56000,552,20546,640187,696969,56782
56000,233,20520,632259,851028,218769
56000,290,20549,723949,851597,127648
56000,125,20661,570632,697533,126901
56000,74,20711,707087,866635,159548
56000,234,20696,665572,848039,182467
56000,305,20646,622414,747173,124759
56000,324,20410,608997,877748,268751
56000,82,20645,665976,878746,212770
56000,142,20597,586241,839094,252853
56000,463,20571,637788,1069286,431498
56000,230,20660,587813,798500,210687
56000,407,20479,684716,841238,156522
56000,504,20670,641499,765367,123868
56000,348,20654,603916,742372,138456
56000,269,20735,592944,682284,89340
56000,61,20687,629292,740981,111689
56000,403,20650,552469,796076,243607
56000,211,20537,655727,812190,156463
56000,435,20641,643658,669818,26160
56000,351,20623,514667,871875,357208
56000,331,20708,531746,803917,272171
57000,129,20837,822959,1036180,213221
57000,177,21048,547102,772583,225481
57000,307,20952,767458,775922,8464
57000,122,20950,615763,786793,171030
57000,194,21034,559331,682340,123009
57000,290,21007,685917,885453,199536
57000,493,20915,587266,751519,164253
57000,200,20942,568046,793760,225714
57000,302,20888,649482,841840,192358
57000,486,21007,675257,863565,188308
57000,279,20801,638793,706726,67933
57000,327,20885,687172,780138,92966
57000,208,21057,611431,804019,192588
57000,491,20922,572163,715912,143749
57000,427,20964,611258,704931,93673
57000,120,20958,595168,728257,133089
57000,305,21020,599852,832413,232561
57000,476,20957,728468,783600,55132
57000,404,21099,626160,751476,125316
57000,209,20964,913819,914357,538
57000,669,20899,570269,835654,265385
57000,143,20974,531429,811191,279762
57000,365,20864,643099,799158,156059
57000,112,21033,706730,771886,65156
57000,221,20824,593302,1056849,463547
57000,274,21102,581442,851473,270031
57000,292,21021,750751,997306,246555
57000,437,21024,625434,779584,154150
57000,281,21040,641334,715010,73676
57000,592,21002,640162,760840,120678
57000,95,20901,606017,743368,137351
57000,99,20921,648927,884956,236029
57000,133,20869,567040,721357,154317
57000,508,20936,721516,849591,128075
57000,143,21010,622130,738092,115962
57000,473,20883,687538,977459,289921
57000,578,20947,692898,940818,247920
57000,615,20917,741337,806054,64717
57000,167,20979,588021,742182,154161
57000,250,21071,705086,831168,126082
57000,393,20966,600396,953713,353317
57000,308,21017,618177,761066,142889
57000,427,21044,621963,765360,143397
57000,43,20900,694285,850440,156155
57000,230,21060,595039,850017,254978
57000,306,21068,581408,753584,172176
57000,226,20939,703332,793325,89993
57000,489,21001,716750,750566,33816
57000,296,21060,678080,796490,118410
57000,458,20975,662091,822360,160269
58000,234,21356,688008,875803,187795
58000,333,21327,743227,857648,114421
58000,232,21302,628754,809732,180978
58000,269,21368,660983,792092,131109
58000,210,21327,640850,813643,172793
58000,134,21238,645813,879830,234017
58000,229,21419,668978,834908,165930
58000,526,21365,692973,817878,124905
58000,219,21320,951593,994491,42898
58000,161,21259,701986,913228,211242
58000,152,21454,759678,859167,99489
58000,451,21135,668509,770333,101824
58000,157,21408,687920,845161,157241
58000,257,21324,632461,992046,359585
58000,168,21361,692554,790813,98259
58000,430,21396,621205,693651,72446
58000,230,21303,619106,765454,146348
58000,644,21250,604249,1018729,414480
58000,387,21334,707243,881585,174342
58000,388,21369,675410,845810,170400
58000,455,21375,601981,962799,360818
58000,213,21359,622116,753492,131376
58000,153,21301,733963,800580,66617
58000,151,21430,752311,942421,190110
58000,268,21370,722599,782098,59499
58000,639,21303,685437,782792,97355
58000,327,21216,705715,835689,129974
58000,245,21373,697238,787177,89939
58000,303,21430,635367,821673,186306
58000,144,21288,685934,869801,183867
58000,309,21276,613900,803337,189437
58000,143,21388,712308,825833,113525
58000,516,21325,680797,783714,102917
58000,488,21347,684839,759444,74605
58000,396,21321,604763,695899,91136
58000,457,21244,710795,791647,80852
58000,296,21395,640166,884933,244767
58000,177,21311,638929,845916,206987
58000,164,21372,595581,725535,129954
58000,365,21397,570798,902020,331222
58000,643,21341,690506,794397,103891
58000,290,21343,586289,1047090,460801
58000,377,21388,690932,864583,173651
58000,134,21373,694926,733523,38597
58000,251,21324,671657,721950,50293
58000,307,21326,651707,887953,236246
58000,131,21422,582311,774323,192012
58000,443,21387,843065,870877,27812
58000,326,21271,556337,839448,283111
58000,351,21383,799328,852550,53222
59000,519,21647,584944,767012,182068
59000,151,21589,688036,932246,244210
59000,244,21737,622463,804026,181563
59000,177,21697,720415,792794,72379
59000,185,21625,623307,807303,183996
59000,399,21669,659786,803682,143896
59000,113,21785,644919,792589,147670
59000,440,21741,574018,789885,215867
59000,497,21636,683365,782643,99278
59000,246,21726,666116,786867,120751
59000,396,21596,762858,831490,68632
59000,177,21744,697538,863954,166416
59000,363,21724,647589,811137,163548
59000,433,21599,638939,811330,172391
59000,178,21654,711873,874989,163116
59000,244,21737,696956,798150,101194
59000,376,21751,648689,765478,116789
59000,204,21833,644418,808271,163853
59000,522,21778,682644,768922,86278
59000,147,21732,562488,778410,215922
59000,83,21695,894499,946416,51917
59000,451,21681,675350,749531,74181
59000,180,21674,603743,769625,165882
59000,225,21660,608141,851908,243767
59000,524,21735,672281,895137,222856
59000,198,21645,624295,762172,137877
59000,26,21706,788160,840472,52312
59000,279,21742,587752,818487,230735
59000,123,21759,667925,741189,73264
59000,270,21688,619446,829541,210095
59000,508,21723,632025,714976,82951
59000,337,21695,665852,952404,286552
59000,557,21548,795259,1064317,269058
59000,248,21715,751236,800785,49549
59000,148,21673,632816,806639,173823
59000,348,21719,695461,843936,148475
59000,165,21809,604867,770327,165460
59000,316,21683,668544,849522,180978
59000,106,21737,662189,928786,266597
59000,247,21564,672440,890226,217786
59000,308,21705,646847,855631,208784
59000,198,21689,617936,784761,166825
59000,252,21623,728298,839846,111548
59000,120,21704,676264,840699,164435
59000,192,21806,666767,780765,113998
59000,157,21628,758240,776186,17946
59000,477,21809,679154,771106,91952
59000,246,21676,660231,850848,190617
59000,311,21732,707103,821866,114763
59000,285,21715,616509,1010077,393568
60000,235,22072,666578,831955,165377
60000,192,22094,773412,854601,81189
60000,341,21990,734501,949494,214993
60000,332,22046,646412,885434,239022
60000,159,22020,774754,867098,92344
60000,114,22054,765671,791803,26132
60000,402,22010,792215,831296,39081
60000,406,22096,754951,842281,87330
60000,290,22165,616915,748160,131245
60000,397,22054,716726,759916,43190
60000,177,22193,762451,904681,142230
60000,450,22062,723024,769522,46498
60000,433,22098,723336,812136,88800
60000,523,22185,648443,873983,225540
60000,59,22227,660635,882772,222137
60000,525,22208,812214,889378,77164
60000,227,22005,569702,701757,132055
60000,215,21967,630618,837490,206872
60000,205,22023,687876,784726,96850
60000,374,22076,636607,912909,276302
60000,52,21999,697414,929902,232488
60000,237,21983,691737,858918,167181
60000,392,21989,650223,830795,180572
60000,328,22064,586573,890845,304272
60000,407,22056,620990,870222,249232
60000,174,22078,767025,862564,95539
60000,304,22011,648549,822485,173936
60000,371,22048,752666,851719,99053
60000,366,22138,678193,785935,107742
60000,579,21992,763791,816880,53089
60000,248,21926,598297,892907,294610
60000,580,22020,696573,901265,204692
60000,134,22172,672618,885754,213136
60000,601,22246,624968,695806,70838
60000,141,21949,727162,841957,114795
60000,284,22134,709045,781163,72118
60000,262,22091,733052,924693,191641
60000,117,22138,636681,813679,176998
60000,448,22022,752851,915262,162411
60000,332,22068,808779,848215,39436
60000,430,22124,898054,1060219,162165
60000,290,22073,716107,870810,154703
60000,261,22138,693066,944865,251799
60000,81,22014,745125,846852,101727
60000,275,22041,690557,826908,136351
60000,325,21944,720815,876457,155642
60000,213,22005,600545,798688,198143
60000,591,22026,695320,816121,120801
60000,243,22141,748659,798403,49744
60000,520,22061,629752,787610,157858
61000,448,22515,736949,821403,84454
61000,75,22403,675699,879052,203353
61000,428,22348,643862,848069,204207
61000,294,22328,588904,869289,280385
61000,404,22470,615183,890757,275574
61000,112,22413,672538,893444,220906
61000,137,22603,719103,979223,260120
61000,329,22531,731932,944841,212909
61000,323,22437,739530,829520,89990
61000,212,22391,740056,790530,50474
61000,719,22368,696282,912411,216129
61000,205,22380,683785,788580,104795
61000,280,22510,629123,821313,192190
61000,856,22474,667156,854269,187113
61000,368,22356,791653,827912,36259
61000,59,22513,716201,1048688,332487
61000,181,22350,674345,876267,201922
61000,574,22528,798597,817965,19368
61000,442,22461,697013,794359,97346
61000,519,22514,694457,898448,203991
61000,227,22370,610405,862770,252365
61000,141,22533,796232,921253,125021
61000,209,22423,746371,929784,183413
61000,89,22475,711456,953661,242205
61000,354,22541,722479,876387,153908
61000,157,22453,772716,812364,39648
61000,202,22416,697530,903202,205672
61000,117,22307,687006,865946,178940
61000,409,22447,660172,951477,291305
61000,144,22603,671883,754442,82559
61000,505,22417,729960,797017,67057
61000,127,22469,678094,875473,197379
61000,515,22449,657345,984804,327459
61000,273,22396,699979,783779,83800
61000,237,22437,643326,801493,158167
61000,469,22544,737879,794073,56194
61000,202,22375,705227,864735,159508
61000,532,22446,706423,806740,100317
61000,700,22344,776550,951501,174951
61000,669,22458,579832,796783,216951
61000,316,22539,746266,772012,25746
61000,351,22277,810669,1036653,225984
61000,705,22558,733961,856120,122159
61000,178,22264,746159,802816,56657
61000,591,22549,714942,1026509,311567
61000,164,22385,768490,917714,149224
61000,195,22523,657239,826309,169070
61000,157,22425,678959,850971,172012
61000,172,22460,585013,843720,258707
61000,442,22353,721639,907688,186049
62000,116,22649,675991,744319,68328
62000,345,22797,691858,846425,154567
62000,209,22773,697057,818939,121882
62000,246,22752,702824,810719,107895
62000,183,22920,733786,805639,71853
62000,121,22796,625014,901084,276070
62000,321,22854,714090,920655,206565
62000,494,22669,723174,830404,107230
62000,398,22734,702357,872044,169687
62000,751,22680,903142,1111558,208416
62000,178,22839,748586,848839,100253
62000,535,22752,780338,998961,218623
62000,275,22998,721031,784891,63860
62000,391,22764,755270,897092,141822
62000,162,22803,672055,996300,324245
62000,98,23015,655286,888098,232812
62000,443,22790,690211,1148678,458467
62000,439,22660,685471,945561,260090
62000,393,22769,729593,881770,152177
62000,50,22798,688160,843981,155821
62000,103,22854,685959,834326,148367
62000,320,22850,740525,1032399,291874
62000,472,22714,689481,815930,126449
62000,238,22724,826694,1040984,214290
62000,350,22793,634501,780700,146199
62000,413,22837,862013,953610,91597
62000,175,22993,570580,956344,385764
62000,476,22744,757859,775629,17770
62000,250,22763,638591,1087559,448968
62000,383,22723,707743,749476,41733
62000,76,22869,661850,847570,185720
62000,460,22719,680116,815183,135067
62000,123,22726,724917,936774,211857
62000,93,22842,764936,954028,189092
62000,305,22802,685142,835869,150727
62000,302,22878,614734,832314,217580
62000,352,22873,711048,854245,143197
62000,483,22727,719739,925152,205413
62000,263,22844,718349,841484,123135
62000,172,22796,681538,810658,129120
62000,258,22839,826650,839645,12995
62000,243,22981,675229,877895,202666
62000,329,22830,744579,776674,32095
62000,189,22839,728959,855539,126580
62000,237,22800,643314,884704,241390
62000,199,22881,692454,876616,184162
62000,247,22887,746877,1007723,260846
62000,255,22856,957713,976227,18514
62000,223,22945,662069,785597,123528
62000,422,22909,684041,818362,134321
63000,430,23123,705503,1073238,367735
63000,405,23213,688868,809109,120241
63000,394,23161,653437,810344,156907
63000,71,23127,894349,1030632,136283
63000,84,23005,704117,871142,167025
63000,558,23169,691904,884463,192559
63000,153,23214,719878,911454,191576
63000,232,23122,666318,960345,294027
63000,358,23064,687765,876879,189114
63000,139,23179,738830,891337,152507
63000,93,23124,628976,863036,234060
63000,523,23169,870512,1082425,211913
63000,324,23160,656279,960885,304606
63000,437,23076,638044,947167,309123
63000,40,23248,679238,922399,243161
63000,63,23182,656106,884902,228796
63000,97,23292,643605,982988,339383
63000,277,23214,641626,858649,217023
63000,74,23259,760931,794464,33533
63000,355,23080,709334,786204,76870
63000,324,23135,700458,834124,133666
63000,489,23106,696304,891744,195440
63000,567,23112,656360,876559,220199
63000,335,23382,682845,864859,182014
63000,108,23175,658241,814195,155954
63000,121,23227,598719,847199,248480
63000,76,23136,785185,923836,138651
63000,229,23180,710636,827815,117179
63000,244,23282,703570,940079,236509
63000,499,23289,773058,905472,132414
63000,301,23078,790676,856201,65525
63000,145,23015,692783,841806,149023
63000,36,23126,754463,879452,124989
63000,529,23238,707047,1059632,352585
63000,470,23181,684338,833896,149558
63000,157,23197,696447,857865,161418
63000,382,23202,643483,836310,192827
63000,613,23181,723820,970528,246708
63000,176,23144,693242,879895,186653
63000,127,23272,746245,868468,122223
63000,585,23087,719238,836242,117004
63000,71,23208,738396,897295,158899
63000,215,23194,904288,927351,23063
63000,342,23182,729556,830513,100957
63000,503,23179,786655,963278,176623
63000,390,23145,663493,854336,190843
63000,177,23224,729457,817101,87644
63000,291,23271,708044,906402,198358
63000,407,23112,676242,874015,197773
63000,80,23053,666147,905732,239585
64000,359,23578,751305,925707,174402
64000,240,23723,751184,909509,158325
64000,753,23457,836760,901873,65113
64000,414,23531,667562,849874,182312
64000,382,23616,681280,1048746,367466
64000,408,23666,642153,981282,339129
64000,195,23633,799882,807320,7438
64000,175,23592,828597,999000,170403
64000,234,23555,752691,900844,148153
64000,302,23648,738518,856389,117871
64000,235,23512,774936,906460,131524
64000,311,23490,779621,961597,181976
64000,358,23547,738066,898793,160727
64000,110,23482,744655,1021874,277219
64000,193,23564,696134,823799,127665
64000,263,23504,719460,902820,183360
64000,555,23626,748465,872053,123588
64000,115,23474,707670,918545,210875
64000,493,23644,845032,860519,15487
64000,642,23438,739144,936822,197678
64000,155,23550,738111,814453,76342
64000,225,23669,803970,831625,27655
64000,381,23521,686469,792178,105709
64000,511,23699,649387,895012,245625
64000,229,23536,659772,808414,148642
64000,257,23636,781268,974480,193212
64000,333,23619,912447,959509,47062
64000,253,23521,826030,1016173,190143
64000,598,23537,784829,840461,55632
64000,203,23527,747531,866100,118569
64000,147,23462,760982,1165382,404400
64000,151,23500,658578,828474,169896
64000,196,23523,835740,1038662,202922
64000,159,23627,731605,865544,133939
64000,394,23437,760147,942546,182399
64000,857,23587,667433,879631,212198
64000,452,23574,709502,791571,82069
64000,306,23671,740172,853982,113810
64000,640,23586,840786,933869,93083
64000,834,23420,681305,903321,222016
64000,485,23292,680420,939119,258699
64000,132,23475,731383,839015,107632
64000,339,23596,966138,985060,18922
64000,113,23434,870071,880285,10214
64000,499,23607,955488,956114,626
64000,318,23558,833002,893595,60593
64000,364,23425,667515,827157,159642
64000,172,23388,804443,948649,144206
64000,738,23628,729477,914508,185031
64000,235,23556,664700,1112592,447892
65000,162,23912,857297,921896,64599
65000,117,23974,1067049,1069550,2501
65000,385,23952,753831,1215797,461966
65000,274,24008,735431,912697,177266
65000,640,23859,749992,876069,126077
65000,454,23921,661659,1006452,344793
65000,113,23894,729362,977016,247654
65000,166,23880,751347,877314,125967
65000,217,23973,854222,1037463,183241
65000,466,24051,1012575,1114230,101655
65000,38,23881,676773,805217,128444
65000,985,23918,778664,982383,203719
65000,332,23992,752785,938599,185814
65000,509,23862,737052,852699,115647
65000,355,24013,745520,899737,154217
65000,139,23987,701520,850887,149367
65000,465,24014,966852,1092461,125609
65000,107,23974,774939,851565,76626
65000,424,23818,749942,941520,191578
65000,259,24065,817232,1045112,227880
65000,162,23896,653876,859528,205652
65000,178,23891,641213,904306,263093
65000,264,23800,752610,916096,163486
65000,67,24047,746749,969916,223167
65000,120,23963,687446,970413,282967
65000,421,23979,746922,847452,100530
65000,364,23875,809187,1042185,232998
65000,498,24048,899755,1035493,135738
65000,480,23938,708978,1203318,494340
65000,427,24166,683871,921289,237418
65000,222,23772,772931,960481,187550
65000,331,23962,728536,825688,97152
65000,339,23833,857384,1026124,168740
65000,95,23854,646260,932155,285895
65000,358,23860,770717,1032152,261435
65000,511,23731,686394,833686,147292
65000,135,24022,831671,894457,62786
65000,227,23908,734180,859267,125087
65000,525,23920,736054,1017420,281366
65000,262,24070,819158,944008,124850
65000,271,23973,964689,1170771,206082
65000,265,23899,728507,929857,201350
65000,182,23786,667114,940530,273416
65000,304,23813,787823,1002245,214422
65000,133,24115,713333,972297,258964
65000,119,23802,746846,830517,83671
65000,713,23995,763065,789907,26842
65000,55,23860,756428,982929,226501
65000,154,23962,748530,889700,141170
65000,233,23932,759629,1080393,320764
66000,399,24186,775722,815591,39869
66000,119,24381,749541,862817,113276
66000,351,24290,713244,1052517,339273
66000,236,24286,714738,916353,201615
66000,434,24261,817550,953653,136103
66000,293,24414,848664,993081,144417
66000,706,24299,710644,904913,194269
66000,183,24268,770918,1011787,240869
66000,150,24207,673744,1030734,356990
66000,541,24287,780821,972975,192154
66000,509,24284,702145,952697,250552
66000,226,24161,794528,998378,203850
66000,238,24256,798190,1082100,283910
66000,208,24216,707024,905464,198440
66000,485,24360,793258,905144,111886
66000,741,24379,778256,901742,123486
66000,160,24312,918137,975578,57441
66000,290,24202,706510,880947,174437
66000,237,24347,697701,874189,176488
66000,660,24209,894620,897077,2457
66000,136,24172,824421,1097712,273291
66000,230,24235,660243,1030904,370661
66000,330,24240,695928,889709,193781
66000,43,24162,770357,876945,106588
66000,281,24379,907526,979474,71948
66000,278,24175,692954,875204,182250
66000,160,24266,754381,866043,111662
66000,438,24321,918613,1030589,111976
66000,269,24349,630632,960202,329570
66000,341,24316,728145,876639,148494
66000,305,24229,787847,900911,113064
66000,534,24280,752460,852052,99592
66000,113,24302,789467,861922,72455
66000,594,24273,685870,838295,152425
66000,339,24310,791158,1098594,307436
66000,385,24217,674742,944631,269889
66000,281,24408,779043,890242,111199
66000,243,24356,731634,879753,148119
66000,376,24199,831757,885562,53805
66000,399,24214,848096,920804,72708
66000,160,24283,731137,1012629,281492
66000,597,24367,833617,924323,90706
66000,569,24140,776494,826057,49563
66000,487,24341,803362,867823,64461
66000,286,24372,795900,977780,181880
66000,19,24169,726971,869136,142165
66000,542,24249,749082,920458,171376
66000,286,24303,866708,945774,79066
66000,213,24374,734833,780248,45415
66000,400,24283,692241,911719,219478
67000,312,24646,854500,948852,94352
67000,145,24621,800870,967839,166969
67000,244,24717,752314,784544,32230
67000,400,24684,738362,1042522,304160
67000,712,24762,727974,938199,210225
67000,270,24603,860532,916614,56082
67000,305,24727,901281,1003718,102437
67000,707,24692,724419,1009593,285174
67000,200,24534,776296,935985,159689
67000,106,24641,725167,972385,247218
67000,327,24565,740653,983517,242864
67000,528,24591,868819,966773,97954
67000,377,24733,772321,973264,200943
67000,319,24777,1114770,1174345,59575
67000,333,24454,643343,934697,291354
67000,199,24610,954293,1024822,70529
67000,332,24604,675160,1086847,411687
67000,515,24713,744674,1049127,304453
67000,357,24651,732091,946362,214271
67000,244,24574,732527,974397,241870
67000,147,24539,817883,980675,162792
67000,236,24648,841067,1357175,516108
67000,195,24746,715037,925608,210571
67000,897,24501,643305,826284,182979
67000,242,24692,724750,887933,163183
67000,52,24611,730960,977251,246291
67000,363,24698,651242,907973,256731
67000,128,24415,694427,903116,208689
67000,250,24646,1071614,1160076,88462
67000,373,24648,773879,891690,117811
67000,564,24711,1016834,1038799,21965
67000,416,24624,861078,944234,83156
67000,93,24633,853050,951159,98109
67000,399,24732,792271,863074,70803
67000,413,24576,765503,879376,113873
67000,367,24649,782873,958938,176065
67000,182,24597,767338,1043867,276529
67000,24,24676,660059,888045,227986
67000,699,24664,746545,1027749,281204
67000,70,24664,796242,1065861,269619
67000,269,24477,837526,970963,133437
67000,252,24605,672125,960767,288642
67000,157,24680,777336,861663,84327
67000,719,24675,736095,887119,151024
67000,810,24665,760162,988441,228279
67000,328,24603,732207,1062013,329806
67000,342,24775,777051,921766,144715
67000,213,24589,816291,956706,140415
67000,386,24677,822505,937175,114670
67000,348,24631,892622,958195,65573
68000,166,24988,927631,1067340,139709
68000,402,25017,866325,980482,114157
68000,189,24976,703849,1005477,301628
68000,247,25014,762580,1237539,474959
68000,384,25038,779022,1084008,304986
68000,363,25031,741929,1073714,331785
68000,358,24995,679838,858394,178556
68000,383,25003,713116,970578,257462
68000,463,25013,968775,969100,325
68000,173,25051,987222,1071929,84707
68000,460,24980,747971,946549,198578
68000,517,24976,718509,876501,157992
68000,592,24864,752164,1178534,426370
68000,318,25042,776394,952354,175960
68000,655,25004,667606,963703,296097
68000,623,25098,797311,1049015,251704
68000,237,25007,691492,930342,238850
68000,382,25055,1017852,1067416,49564
68000,590,24924,719964,805476,85512
68000,663,24970,789534,828065,38531
68000,299,24920,684520,897061,212541
68000,71,25092,915930,971440,55510
68000,151,25011,777850,939662,161812
68000,243,24925,946514,982732,36218
68000,301,25064,834058,946886,112828
68000,327,25064,797906,831594,33688
68000,342,25047,757001,902720,145719
68000,597,25116,716932,1082119,365187
68000,80,25153,738239,957867,219628
68000,247,25192,824300,838893,14593
68000,596,24917,994659,1064976,70317
68000,42,25050,746873,979761,232888
68000,264,24967,929052,1050410,121358
68000,511,25045,1028567,1048280,19713
68000,312,24940,738520,963449,224929
68000,125,25058,843396,856635,13239
68000,567,25037,717542,915978,198436
68000,275,24979,760783,929071,168288
68000,345,25010,1019881,1085613,65732
68000,406,24928,822655,1146936,324281
68000,244,25033,780194,948289,168095
68000,192,25129,711634,904049,192415
68000,882,24961,681290,986264,304974
68000,54,25079,836768,908161,71393
68000,346,25111,861060,1179466,318406
68000,138,24986,779968,1063491,283523
68000,82,24793,781110,989270,208160
68000,359,24965,817155,1049945,232790
68000,161,25133,710668,957322,246654
68000,336,25056,802563,843658,41095
69000,403,25355,800052,1009648,209596
69000,152,25507,790968,1148406,357438
69000,538,25400,927218,1014626,87408
69000,174,25481,687615,911861,224246
69000,800,25372,871326,965467,94141
69000,92,25408,842274,914254,71980
69000,39,25214,775364,930475,155111
69000,264,25483,801877,924381,122504
69000,675,25392,781857,932812,150955
69000,394,25468,938118,1052246,114128
69000,350,25381,763261,1041548,278287
69000,90,25518,787652,1116143,328491
69000,308,25299,739406,1024589,285183
69000,201,25414,782095,1200821,418726
69000,451,25336,743660,838300,94640
69000,77,25478,820739,1356859,536120
69000,80,25337,911953,1298632,386679
69000,153,25582,957472,1029054,71582
69000,140,25445,809300,901737,92437
69000,430,25332,938909,1027159,88250
69000,587,25441,786346,950547,164201
69000,276,25318,756306,976612,220306
69000,247,25488,930495,947506,17011
69000,342,25272,775222,1102031,326809
69000,339,25282,727125,1045545,318420
69000,132,25423,758254,1180954,422700
69000,133,25318,795936,843659,47723
69000,360,25239,840106,904013,63907
69000,263,25229,867784,1026700,158916
69000,89,25448,868974,1068257,199283
69000,87,25394,768756,875461,106705
69000,582,25419,756065,931849,175784
69000,215,25280,822014,958152,136138
69000,484,25409,907074,1082050,174976
69000,196,25388,876519,1103057,226538
69000,151,25284,809936,1005479,195543
69000,190,25397,765002,870428,105426
69000,75,25445,1032381,1040973,8592
69000,229,25480,859959,912595,52636
69000,467,25365,764743,890213,125470
69000,106,25412,807370,1010609,203239
69000,107,25318,732076,962603,230527
69000,98,25323,775528,1104684,329156
69000,353,25201,803388,840000,36612
69000,282,25414,717265,909855,192590
69000,260,25396,722990,1069489,346499
69000,293,25503,973790,1015298,41508
69000,232,25319,788905,1047272,258367
69000,207,25348,760617,823867,63250
69000,287,25466,919157,977396,58239
70000,445,25786,875048,1005404,130356
70000,72,25856,753990,867581,113591
70000,352,25864,731785,945208,213423
70000,392,25848,752349,1006455,254106
70000,256,25760,645301,935942,290641
70000,439,25718,799511,909701,110190
70000,348,25766,770327,1056433,286106
70000,551,25718,795417,1351194,555777
70000,122,25727,824869,1076392,251523
70000,324,25772,859054,964070,105016
70000,353,25697,943307,1156151,212844
70000,82,25812,898115,984604,86489
70000,374,25716,768094,939397,171303
70000,486,25657,927501,1085943,158442
70000,136,25776,697510,1064144,366634
70000,262,25725,808880,1092244,283364
70000,513,25710,846219,1008362,162143
70000,92,25796,770512,854310,83798
70000,52,25836,783019,1006367,223348
70000,334,25771,789224,980716,191492
70000,219,25756,815396,933017,117621
70000,492,25851,759708,1064903,305195
70000,332,25864,744020,921960,177940
70000,282,25701,791708,900747,109039
70000,462,25707,758663,929024,170361
70000,849,25860,1066683,1140058,73375
70000,443,25729,820700,1118555,297855
70000,113,25859,735118,996531,261413
70000,247,25700,889807,1059396,169589
70000,1049,25573,751472,962923,211451
70000,264,25785,753607,985284,231677
70000,203,25935,741552,959883,218331
70000,137,25756,796536,946103,149567
70000,153,25731,940168,1067671,127503
70000,341,25831,729645,907269,177624
70000,117,25753,1060427,1142791,82364
70000,346,25733,926131,1392761,466630
70000,447,25786,660440,1078050,417610
70000,415,25901,682389,924610,242221
70000,193,25661,938461,939991,1530
70000,118,25890,844506,869024,24518
70000,280,25601,837035,1318645,481610
70000,258,25812,884655,1196839,312184
70000,17,25686,820312,1026399,206087
70000,256,25790,831546,1094500,262954
70000,83,25842,948015,959382,11367
70000,66,25787,740341,1032086,291745
70000,571,25878,842455,1135907,293452
70000,413,25816,865910,900915,35005
70000,312,25797,758264,904705,146441
71000,493,26070,818399,960634,142235
71000,359,26137,985536,1203664,218128
71000,355,26145,877861,1035507,157646
71000,97,26078,956512,976192,19680
71000,148,26167,871698,923780,52082
71000,358,26215,718531,942402,223871
71000,120,25978,923748,1086714,162966
71000,615,26184,714937,1040934,325997
71000,359,26131,894750,964979,70229
71000,507,26090,859479,1081288,221809
71000,314,26039,911994,1017095,105101
71000,372,26132,968592,979759,11167
71000,532,26087,854568,1042919,188351
71000,248,25905,914126,1182317,268191
71000,314,26124,718175,853244,135069
71000,264,26092,842740,1016918,174178
71000,485,26150,1081576,1143091,61515
71000,58,26102,966357,1053351,86994
71000,151,26042,868479,1153405,284926
71000,384,26189,781545,998072,216527
71000,264,26067,779813,962843,183030
71000,664,26179,865071,940708,75637
71000,443,26084,876799,963863,87064
71000,316,26144,735749,906109,170360
71000,472,26165,733074,929503,196429
71000,351,26175,844497,940497,96000
71000,315,26288,872178,1101052,228874
71000,449,26151,756178,913430,157252
71000,505,26181,859807,990128,130321
71000,457,26182,917479,979526,62047
71000,428,26091,906914,1017090,110176
71000,440,26111,762944,941001,178057
71000,212,26037,802186,1026574,224388
71000,191,26084,810001,979552,169551
71000,121,26173,719544,1163694,444150
71000,334,26171,721182,934877,213695
71000,350,26176,817681,1139405,321724
71000,424,26256,748195,978632,230437
71000,237,26231,880872,1181320,300448
71000,71,26026,774631,937900,163269
71000,334,26202,790615,919996,129381
71000,150,26152,915169,1352423,437254
71000,45,26155,862938,1013348,150410
71000,549,26016,821363,1172012,350649
71000,280,26011,785063,900160,115097
71000,101,26218,717218,1188766,471548
71000,375,25990,737564,1026811,289247
71000,434,26255,815133,1067751,252618
71000,248,26025,814171,1221946,407775
71000,407,26025,857342,1047348,190006
72000,464,26430,752191,1124978,372787
72000,756,26373,1098021,1099478,1457
72000,770,26452,849307,1081963,232656
72000,381,26421,1132957,1200022,67065
72000,335,26722,921903,1012499,90596
72000,293,26569,917587,1116378,198791
72000,194,26411,830701,977552,146851
72000,118,26410,910317,999738,89421
72000,133,26508,816721,923726,107005
72000,349,26375,733830,1069640,335810
72000,356,26525,836036,1111765,275729
72000,232,26549,715800,1030037,314237
72000,237,26444,803030,969629,166599
72000,213,26543,979534,1288570,309036
72000,494,26435,745094,1094312,349218
72000,154,26528,796980,1028700,231720
72000,238,26407,787274,1087657,300383
72000,477,26515,776148,903073,126925
72000,280,26540,961839,1126659,164820
72000,361,26520,791750,1048427,256677
72000,334,26347,836300,1006564,170264
72000,445,26588,855218,1290504,435286
72000,472,26445,761578,1092833,331255
72000,382,26418,834913,962122,127209
72000,180,26705,753572,928559,174987
72000,237,26526,818820,923296,104476
72000,590,26390,877610,986430,108820
72000,208,26637,898861,979850,80989
72000,240,26475,853557,893490,39933
72000,405,26454,1120504,1133371,12867
72000,587,26414,822588,1010245,187657
72000,298,26584,810759,988092,177333
72000,22,26520,789735,997948,208213
72000,174,26530,972973,1015280,42307
72000,203,26589,781169,975005,193836
72000,611,26574,845128,967720,122592
72000,105,26682,858927,1078799,219872
72000,402,26669,736665,935810,199145
72000,167,26605,830951,1098452,267501
72000,473,26395,766244,1025824,259580
72000,127,26514,798843,978279,179436
72000,112,26557,955825,1003976,48151
72000,518,26573,776791,905562,128771
72000,252,26484,852512,924453,71941
72000,303,26392,800034,921040,121006
72000,142,26610,927407,1283109,355702
72000,254,26573,871378,1094218,222840
72000,252,26386,872511,993176,120665
72000,675,26499,855062,925962,70900
72000,146,26533,1010907,1046998,36091
73000,549,26839,753412,1015550,262138
73000,378,26909,750911,1004002,253091
73000,378,26912,840969,1068763,227794
73000,243,26703,852134,1458685,606551
73000,176,26987,841295,992391,151096
73000,39,26912,924803,1038380,113577
73000,243,26941,824602,1026805,202203
73000,366,26780,1205911,1214306,8395
73000,266,26694,859625,1279343,419718
73000,172,26859,756111,1019245,263134
73000,430,26876,775052,1036130,261078
73000,662,26907,721191,1115109,393918
73000,136,26692,888750,1154362,265612
73000,376,26868,822306,896459,74153
73000,551,27013,754432,1092380,337948
73000,220,26871,932561,1047155,114594
73000,258,26892,765139,1036488,271349
73000,577,26902,776849,999442,222593
73000,429,26944,904837,1039460,134623
73000,221,26596,851973,1018648,166675
73000,167,26853,1066043,1154178,88135
73000,361,26860,798837,1007950,209113
73000,221,26757,836664,1165989,329325
73000,414,26638,911052,985138,74086
73000,88,26907,824387,1046518,222131
73000,379,26818,1174021,1184474,10453
73000,255,26804,951353,1000319,48966
73000,375,26920,845899,994409,148510
73000,153,26930,817268,1312449,495181
73000,820,26952,834904,1216304,381400
73000,186,26892,831013,928461,97448
73000,555,26799,926972,1075347,148375
73000,51,26864,823203,1236685,413482
73000,304,26816,852171,905690,53519
73000,303,26808,718468,1004458,285990
73000,319,26981,691472,999144,307672
73000,388,26899,814652,924537,109885
73000,519,26898,771786,966046,194260
73000,377,26974,796726,998054,201328
73000,415,26810,814060,978666,164606
73000,463,26796,871290,1202553,331263
73000,127,26824,791401,997711,206310
73000,223,26811,835018,1049139,214121
73000,263,26883,950667,1104948,154281
73000,248,26831,789111,1002721,213610
73000,410,26740,911915,1053881,141966
73000,258,27073,780501,1107703,327202
73000,283,26949,926611,1140320,213709
73000,194,26954,833273,989349,156076
73000,159,26685,844959,958749,113790
74000,233,27270,830818,947274,116456
74000,418,27258,881164,1093739,212575
74000,358,27275,930121,1238079,307958
74000,234,27135,892391,1111268,218877
74000,404,27111,837433,1326012,488579
74000,619,27215,796561,1081913,285352
74000,305,27306,777868,1008956,231088
74000,547,27118,937280,1207018,269738
74000,588,27124,865703,1303940,438237
74000,494,27215,919301,1056847,137546
74000,533,27273,973889,1197333,223444
74000,116,27418,907475,1143970,236495
74000,403,27203,831197,1094055,262858
74000,204,27140,872441,1068841,196400
74000,146,27321,849385,1009760,160375
74000,392,27372,932318,1039442,107124
74000,310,27091,884442,1006345,121903
74000,204,27284,857459,1030981,173522
74000,275,27254,767458,1010158,242700
74000,326,26924,962984,1071496,108512
74000,207,27196,838115,1166838,328723
74000,168,27392,710409,981060,270651
74000,247,27337,977065,1088234,111169
74000,666,27278,851648,1049786,198138
74000,567,27221,888210,950163,61953
74000,403,27156,809945,1079091,269146
74000,164,27243,858592,1033856,175264
74000,317,27221,950775,1022618,71843
74000,229,27177,828587,956432,127845
74000,145,27283,1043562,1156165,112603
74000,118,27131,930943,1068356,137413
74000,439,27280,871701,1014452,142751
74000,444,27183,1039654,1053345,13691
74000,433,27205,836441,1025559,189118
74000,453,27298,839916,974826,134910
74000,6,27247,1021734,1169162,147428
74000,527,27088,977968,1087940,109972
74000,486,27295,1001290,1055933,54643
74000,293,27207,1073971,1216123,142152
74000,365,27271,744722,956426,211704
74000,243,27222,745000,1034897,289897
74000,1042,27316,740478,1007459,266981
74000,173,27144,788425,1131553,343128
74000,59,27272,846466,1066470,220004
74000,129,27106,971603,1152106,180503
74000,282,27202,962308,1014509,52201
74000,207,27258,814777,984162,169385
74000,331,27158,771013,1043243,272230
74000,96,27233,826296,929485,103189
74000,424,27244,894520,1086447,191927
75000,442,27647,794454,1062486,268032
75000,400,27573,852319,1232448,380129
75000,43,27540,1018738,1063264,44526
75000,208,27579,877325,1067739,190414
75000,415,27672,846904,1163454,316550
75000,351,27525,783455,1020620,237165
75000,417,27784,1110246,1237145,126899
75000,526,27623,853459,1239260,385801
75000,318,27622,839325,1167850,328525
75000,183,27722,794184,1057157,262973
75000,111,27471,877918,1126439,248521
75000,312,27502,870568,1120530,249962
75000,67,27589,836906,1159576,322670
75000,384,27685,901109,1044896,143787
75000,226,27649,832628,1267639,435011
75000,449,27563,859673,1265489,405816
75000,339,27630,875257,1075474,200217
75000,435,27447,848482,1138148,289666
75000,342,27600,841699,1194539,352840
75000,354,27667,783264,1046103,262839
75000,125,27483,806416,966119,159703
75000,640,27674,918489,1028292,109803
75000,527,27609,866817,1134177,267360
75000,409,27517,862622,1084641,222019
75000,458,27612,951710,1285667,333957
75000,255,27539,812402,955405,143003
75000,345,27647,816743,1077663,260920
75000,225,27589,807049,1032313,225264
75000,200,27577,787529,1019824,232295
75000,633,27563,1014219,1050637,36418
75000,539,27500,807969,1064243,256274
75000,29,27599,913657,1273742,360085
75000,613,27594,826060,1179749,353689
75000,135,27731,914703,1132354,217651
75000,177,27623,958562,1128493,169931
75000,230,27590,915720,1079654,163934
75000,438,27474,1132098,1166630,34532
75000,321,27543,976590,1269930,293340
75000,335,27612,930472,1101128,170656
75000,420,27703,961329,1038460,77131
75000,116,27502,951058,1057088,106030
75000,196,27528,884525,1041817,157292
75000,304,27601,828521,1252616,424095
75000,846,27626,907352,1086339,178987
75000,531,27621,922846,1034294,111448
75000,368,27596,841980,907776,65796
75000,277,27470,888150,1014307,126157
75000,361,27461,859385,1141328,281943
75000,324,27457,1263502,1292736,29234
75000,477,27635,869849,1185605,315756
76000,400,28003,915636,1274545,358909
76000,307,28125,822082,1053349,231267
76000,593,28022,793814,1364806,570992
76000,14,27877,881053,973471,92418
76000,145,27903,953393,1140213,186820
76000,163,27873,897114,1016989,119875
76000,567,27876,819418,1267649,448231
76000,394,28068,756901,1021203,264302
76000,395,27996,964605,1111900,147295
76000,203,28101,945333,1084915,139582
76000,107,27893,910575,1334737,424162
76000,356,27859,819150,973807,154657
76000,432,28012,845423,1061239,215816
76000,76,27893,840226,1264665,424439
76000,93,27889,872848,1088171,215323
76000,823,27989,816816,1257987,441171
76000,110,28009,907584,1142186,234602
76000,254,27952,836478,1104704,268226
76000,918,27872,928266,1016457,88191
76000,519,28018,854855,1143573,288718
76000,35,28042,912602,1257506,344904
76000,351,27973,933231,1001557,68326
76000,439,27975,894427,1007179,112752
76000,96,27943,1104327,1182128,77801
76000,227,27759,801049,1000265,199216
76000,187,27928,865265,1016769,151504
76000,645,28013,736167,1049264,313097
76000,471,28012,1111028,1191200,80172
76000,271,28005,827862,1027928,200066
76000,354,27901,857859,1041410,183551
76000,87,28079,751474,1022544,271070
76000,353,27884,782422,1045666,263244
76000,494,27919,880546,1171601,291055
76000,116,28086,881764,1103203,221439
76000,472,27915,796899,1036647,239748
76000,489,27919,1049514,1056015,6501
76000,176,28211,1001703,1186329,184626
76000,128,27890,784049,1005184,221135
76000,461,28162,779063,962001,182938
76000,529,28137,1087895,1229491,141596
76000,317,27849,801148,1042642,241494
76000,322,28091,864683,1127400,262717
76000,290,28083,945298,1165682,220384
76000,581,28085,835557,1252206,416649
76000,467,27930,934675,1077169,142494
76000,503,27740,822494,1101597,279103
76000,330,27951,980309,1708941,728632
76000,542,27972,1004711,1185179,180468
76000,262,27945,970168,1355795,385627
76000,90,27972,1085482,1148013,62531
77000,383,28429,1030080,1141393,111313
77000,326,28256,846061,1001177,155116
77000,366,28178,829234,1059672,230438
77000,333,28291,809898,1029864,219966
77000,594,28351,779720,959456,179736
77000,562,28381,852422,1181930,329508
77000,488,28194,965784,1138133,172349
77000,397,28410,914720,1074074,159354
77000,316,28273,892559,1057954,165395
77000,698,28426,803079,966178,163099
77000,738,28266,871893,1128206,256313
77000,422,28313,909456,1063784,154328
77000,409,28360,817690,1030729,213039
77000,457,28240,1002413,1071875,69462
77000,706,28317,952888,1239869,286981
77000,202,28236,867194,1056344,189150
77000,187,28262,971986,1251470,279484
77000,351,28257,915835,1098119,182284
77000,315,28465,932111,1037530,105419
77000,471,28385,1103502,1168660,65158
77000,413,28448,873743,1244897,371154
77000,250,28290,995243,1189918,194675
77000,396,28411,956752,1071772,115020
77000,501,28248,904056,1199875,295819
77000,74,28390,795588,971791,176203
77000,463,28332,1014081,1207298,193217
77000,392,28241,820642,1029824,209182
77000,294,28299,830648,1031538,200890
77000,645,28321,978483,1076162,97679
77000,129,28235,1032659,1141238,108579
77000,41,28262,773664,1021432,247768
77000,260,28395,786881,1406899,620018
77000,323,28132,760377,1334145,573768
77000,401,28324,1077189,1196727,119538
77000,133,28315,927953,936457,8504
77000,189,28339,866030,1119291,253261
77000,137,28469,883299,1041738,158439
77000,624,28311,975834,1154003,178169
77000,226,28416,926162,1007848,81686
77000,329,28319,783442,1328023,544581
77000,577,28274,984056,1119425,135369
77000,674,28436,898960,1334475,435515
77000,285,28508,949447,1146545,197098
77000,194,28398,951758,1367768,416010
77000,188,28299,860651,1058418,197767
77000,351,28290,838542,1068511,229969
77000,190,28307,860621,1338008,477387
77000,362,28260,834354,1127335,292981
77000,373,28237,865395,1043694,178299
77000,128,28243,1001367,1137190,135823
78000,89,28651,1008174,1280642,272468
78000,216,28692,852724,1277712,424988
78000,165,28608,1192591,1220369,27778
78000,280,28734,988072,1127550,139478
78000,272,28752,839719,1060691,220972
78000,688,28671,892238,1216932,324694
78000,273,28681,907272,1143581,236309
78000,362,28710,958255,1158194,199939
78000,389,28779,912409,1154604,242195
78000,419,28697,845125,1186916,341791
78000,402,28651,808549,1176644,368095
78000,157,28663,851516,1019410,167894
78000,150,28607,918370,1087106,168736
78000,264,28889,871623,1259904,388281
78000,236,28681,1019320,1253857,234537
78000,398,28567,1015536,1071912,56376
78000,583,28825,787581,1183350,395769
78000,633,28609,928728,1129256,200528
78000,808,28723,848225,1055295,207070
78000,223,28684,1011385,1320329,308944
78000,498,28579,1028843,1118259,89416
78000,315,28714,899604,1271267,371663
78000,272,28540,1133892,1172455,38563
78000,751,28591,1027178,1121980,94802
78000,429,28505,964398,1157601,193203
78000,341,28698,1020997,1044453,23456
78000,526,28735,886846,1157313,270467
78000,268,28677,837882,1006901,169019
78000,402,28695,969706,1036056,66350
78000,469,28568,834817,1111915,277098
78000,406,28681,797870,1053798,255928
78000,737,28621,758584,1121252,362668
78000,151,28762,1035782,1146129,110347
78000,76,28583,826832,1090236,263404
78000,155,28723,884862,1234443,349581
78000,266,28764,929808,1107070,177262
78000,81,28695,872021,1009960,137939
78000,540,28501,876679,1144299,267620
78000,498,28666,933936,1182217,248281
78000,302,28751,824424,1024690,200266
78000,158,28613,833211,1042599,209388
78000,202,28613,927092,1026073,98981
78000,100,28876,955462,1207051,251589
78000,565,28748,890746,1112353,221607
78000,470,28711,920698,1039041,118343
78000,55,28621,1015700,1043267,27567
78000,614,28694,870088,1130766,260678
78000,309,28819,942957,1082286,139329
78000,360,28585,827196,1029346,202150
78000,196,28644,920317,955444,35127
79000,134,29018,811486,1054353,242867
79000,240,28951,1103612,1119624,16012
79000,160,28941,814099,1038552,224453
79000,231,28972,839301,1074305,235004
79000,352,28995,915251,1089673,174422
79000,150,28891,877253,1139748,262495
79000,316,28982,877820,1336999,459179
79000,381,29037,916273,1146373,230100
79000,421,29016,1010481,1075431,64950
79000,716,28978,916204,1029184,112980
79000,282,29044,848963,1087438,238475
79000,408,29075,920921,1012162,91241
79000,594,29045,965947,1087332,121385
79000,505,29164,1014788,1118168,103380
79000,669,28931,945580,1131186,185606
79000,427,29066,855698,1303238,447540
79000,447,29023,1044958,1112371,67413
79000,187,29096,830431,1107143,276712
79000,369,29191,1099437,1190557,91120
79000,251,28923,849468,974890,125422
79000,198,29087,985451,1083554,98103
79000,204,29171,879543,1116700,237157
79000,158,29285,1079659,1366104,286445
79000,252,29115,780438,1180154,399716
79000,330,29100,889019,1076182,187163
79000,445,29008,932671,1105718,173047
79000,311,29053,803802,1210588,406786
79000,307,29081,776828,1017782,240954
79000,134,28904,819137,1284918,465781
79000,369,29069,886078,1100289,214211
79000,322,29102,1049707,1078110,28403
79000,39,28973,879934,1290039,410105
79000,313,29097,936019,1041914,105895
79000,141,29097,1040708,1164830,124122
79000,521,29022,992439,1079253,86814
79000,255,28992,926545,1111594,185049
79000,87,29003,826133,1056192,230059
79000,221,29120,948324,1086748,138424
79000,322,29047,1286380,1298845,12465
79000,65,29184,1091177,1284924,193747
79000,356,29058,974335,1229367,255032
79000,662,29043,961149,1048271,87122
79000,492,29138,1018977,1080092,61115
79000,530,29038,990336,1156260,165924
79000,179,29104,1093808,1125195,31387
79000,141,29168,812413,1198019,385606
79000,311,29241,918282,1037133,118851
79000,126,29156,805821,1060702,254881
79000,482,28971,972974,1088066,115092
79000,294,28913,947000,1113495,166495
80000,469,29498,960339,1287788,327449
80000,191,29489,1089369,1222523,133154
80000,68,29424,909236,1037568,128332
80000,379,29534,883342,1115993,232651
80000,207,29304,896159,1283472,387313
80000,529,29322,911386,1275420,364034
80000,142,29498,1057865,1214384,156519
80000,190,29319,1005893,1086303,80410
80000,225,29545,1026802,1157061,130259
80000,190,29349,790757,1082397,291640
80000,651,29338,947833,1242828,294995
80000,104,29405,942589,1180731,238142
80000,88,29457,879255,1125609,246354
80000,162,29604,1038454,1112787,74333
80000,722,29386,1014025,1054833,40808
80000,186,29402,854662,1080564,225902
80000,327,29471,813997,1097252,283255
80000,267,29503,971059,1090600,119541
80000,374,29565,916463,1140148,223685
80000,491,29378,1088951,1252462,163511
80000,925,29430,902155,1039311,137156
80000,408,29670,907608,1144186,236578
80000,258,29370,1061795,1247950,186155
80000,261,29288,1130362,1331831,201469
80000,721,29390,1067337,1206393,139056
80000,301,29312,1013154,1110558,97404
80000,177,29371,918223,1209317,291094
80000,501,29600,880590,1260945,380355
80000,162,29483,998438,1218585,220147
80000,188,29538,906922,1047137,140215
80000,145,29495,1070974,1149103,78129
80000,291,29535,862713,1126135,263422
80000,609,29533,924841,1151684,226843
80000,32,29467,952101,1074248,122147
80000,713,29434,832933,1168901,335968
80000,282,29370,937660,1088143,150483
80000,274,29263,873924,1100734,226810
80000,191,29461,825609,1391466,565857
80000,776,29381,1177504,1488395,310891
80000,317,29433,1062174,1083996,21822
80000,566,29313,994382,1208972,214590
80000,340,29412,966305,1321343,355038
80000,710,29598,966880,1173146,206266
80000,338,29458,875870,971842,95972
80000,43,29442,983892,1040110,56218
80000,539,29363,976050,1070849,94799
80000,159,29356,836231,1027294,191063
80000,94,29369,909132,1044421,135289
80000,278,29447,829917,1298294,468377
80000,526,29305,984871,1144731,159860
81000,160,29762,824089,1115351,291262
81000,297,29754,1123768,1235788,112020
81000,117,29695,1104640,1244255,139615
81000,521,29801,915712,1068676,152964
81000,210,29671,891889,1116454,224565
81000,255,29732,929838,1113970,184132
81000,606,29800,1151692,1278981,127289
81000,351,29799,955098,1214035,258937
81000,517,29556,1213794,1462089,248295
81000,384,29662,1107890,1223782,115892
81000,523,29929,1129835,1276080,146245
81000,653,29805,945966,1023384,77418
81000,98,29806,1021064,1298763,277699
81000,287,29727,1062692,1070656,7964
81000,640,29801,805362,1204566,399204
81000,557,29893,1116140,1191573,75433
81000,303,29724,904639,1133118,228479
81000,367,29797,1024660,1137092,112432
81000,555,29929,940764,1123751,182987
81000,460,29612,1063440,1564515,501075
81000,268,29682,885045,1091672,206627
81000,234,29813,923184,1391974,468790
81000,427,29784,867293,1181498,314205
81000,138,29761,1036717,1139445,102728
81000,204,29866,934940,1182408,247468
81000,634,29883,1102294,1188464,86170
81000,307,29789,1003713,1188370,184657
81000,399,29764,967688,1159127,191439
81000,319,29812,1052749,1391321,338572
81000,296,29938,940500,1373510,433010
81000,479,29712,1495026,1793017,297991
81000,333,29862,1082750,1235901,153151
81000,480,29810,826283,1133122,306839
81000,728,29829,1078739,1159363,80624
81000,259,29845,1028113,1068118,40005
81000,449,29871,1013764,1185133,171369
81000,247,29902,978086,1169973,191887
81000,424,29784,933467,1055427,121960
81000,686,29803,818994,1056673,237679
81000,479,29849,869583,1402956,533373
81000,85,29795,968085,1065246,97161
81000,326,29809,1062684,1178555,115871
81000,420,29747,960592,1211326,250734
81000,361,29779,1044616,1220952,176336
81000,164,29884,1083985,1111386,27401
81000,201,29905,893233,1014585,121352
81000,91,29738,880792,1239783,358991
81000,363,29742,1045708,1252326,206618
81000,205,29884,889780,1111554,221774
81000,423,29815,952661,1173545,220884
82000,505,30084,1019688,1069257,49569
82000,390,30013,949941,1162238,212297
82000,468,30143,894828,1375422,480594
82000,618,30149,1159161,1391471,232310
82000,238,30087,1068608,1202929,134321
82000,402,30157,889691,1188591,298900
82000,538,30306,1158557,1236118,77561
82000,522,30127,1014583,1225064,210481
82000,372,30160,1163220,1175473,12253
82000,137,30158,937499,1140472,202973
82000,94,30241,965256,1168217,202961
82000,960,30152,1159486,1243379,83893
82000,319,29945,1039758,1184075,144317
82000,217,30153,975478,1342340,366862
82000,487,30102,1007560,1277313,269753
82000,425,30090,1193112,1250646,57534
82000,204,30203,850692,1145568,294876
82000,154,30156,1000582,1299448,298866
82000,476,30238,934874,1212202,277328
82000,245,30217,989613,1256764,267151
82000,387,30104,867346,949234,81888
82000,230,30166,762283,1128407,366124
82000,298,30207,993655,1214383,220728
82000,338,30032,1022487,1262077,239590
82000,430,30205,923041,1081625,158584
82000,358,30121,904281,1239308,335027
82000,385,30247,1035482,1113386,77904
82000,377,30053,880150,1385966,505816
82000,573,30193,926917,1165274,238357
82000,114,30298,1027531,1177952,150421
82000,457,30004,853388,1198373,344985
82000,628,30185,968961,1241657,272696
82000,735,30264,889120,1201073,311953
82000,265,30094,894309,1022410,128101
82000,261,30117,956585,1161578,204993
82000,224,30373,897213,1148487,251274
82000,254,30298,1019390,1123292,103902
82000,388,30180,925953,1199075,273122
82000,729,30136,890386,1075815,185429
82000,92,30089,880398,1112195,231797
82000,604,30101,950872,1250344,299472
82000,202,30202,1070399,1168788,98389
82000,393,30165,895070,1059160,164090
82000,448,30213,958257,1282725,324468
82000,506,30221,1001592,1116320,114728
82000,52,30232,823553,1169074,345521
82000,663,30047,904877,1316166,411289
82000,731,30255,1124343,1230481,106138
82000,549,30216,985371,1186365,200994
82000,182,30198,1019364,1179192,159828
83000,180,30485,1078045,1301225,223180
83000,265,30520,926542,1164926,238384
83000,357,30517,894444,1125050,230606
83000,613,30577,896260,1174515,278255
83000,713,30681,852945,1225355,372410
83000,735,30448,919819,1231101,311282
83000,677,30678,957539,1147289,189750
83000,222,30480,925471,1340674,415203
83000,429,30606,1012651,1212827,200176
83000,566,30517,1048581,1193613,145032
83000,297,30640,984071,1227598,243527
83000,395,30573,1021562,1052814,31252
83000,540,30547,1202479,1370657,168178
83000,84,30557,1116935,1164397,47462
83000,510,30325,934395,1112779,178384
83000,140,30441,1044579,1513333,468754
83000,407,30554,907711,1346865,439154
83000,457,30568,1167190,1203150,35960
83000,484,30553,1084038,1663895,579857
83000,422,30638,970735,1121882,151147
83000,329,30408,1024576,1158781,134205
83000,277,30582,982770,1151895,169125
83000,289,30474,1052594,1110120,57526
83000,411,30496,1031355,1199948,168593
83000,516,30540,907754,1290734,382980
83000,245,30622,1018661,1284590,265929
83000,637,30594,983362,1160969,177607
83000,225,30609,824275,1140106,315831
83000,321,30589,969680,1064883,95203
83000,353,30463,825315,1162051,336736
83000,372,30545,808115,1264865,456750
83000,679,30507,991495,1355189,363694
83000,363,30515,1136349,1432276,295927
83000,642,30458,874884,1150260,275376
83000,606,30582,882051,1498859,616808
83000,292,30551,919785,1211238,291453
83000,496,30603,928679,1109477,180798
83000,453,30505,1029766,1402810,373044
83000,168,30326,1066829,1111141,44312
83000,393,30435,1031137,1356698,325561
83000,574,30377,934277,1213144,278867
83000,949,30582,978509,1065787,87278
83000,206,30607,900591,1131062,230471
83000,189,30596,1038452,1163660,125208
83000,58,30519,988410,1218480,230070
83000,389,30675,1009464,1278354,268890
83000,51,30624,942076,1165612,223536
83000,99,30679,998504,1279853,281349
83000,135,30517,904543,1001698,97155
83000,541,30426,940109,1161394,221285
84000,41,30754,1002440,1159205,156765
84000,897,30825,979706,1252684,272978
84000,74,30848,901817,1083371,181554
84000,322,30887,1222579,1484405,261826
84000,298,31059,939462,1153464,214002
84000,351,30816,1154416,1159335,4919
84000,372,30804,1025206,1157700,132494
84000,461,30901,945892,1217969,272077
84000,224,30789,984952,1489331,504379
84000,372,30806,992951,1300120,307169
84000,659,31027,1032322,1144236,111914
84000,391,30812,1047485,1152074,104589
84000,124,30896,1063125,1174439,111314
84000,273,31055,977317,1287722,310405
84000,449,30716,832129,1298341,466212
84000,350,31088,1002332,1422365,420033
84000,153,30955,976204,1342987,366783
84000,574,31049,1045926,1310483,264557
84000,433,30802,975171,1415723,440552
84000,222,30958,947863,1310053,362190
84000,320,31106,1098863,1302369,203506
84000,273,30952,939774,1089787,150013
84000,205,30838,1057266,1105138,47872
84000,228,30848,1025202,1165284,140082
84000,87,30922,901633,1202587,300954
84000,368,30933,929883,1253699,323816
84000,222,30901,856105,1125728,269623
84000,206,31076,942354,1243116,300762
84000,365,30675,984367,1155412,171045
84000,112,30839,1005645,1091270,85625
84000,204,30981,930526,1088547,158021
84000,485,30866,1060141,1275215,215074
84000,220,30915,991343,1218672,227329
84000,254,30784,905144,1131052,225908
84000,243,30703,1069304,1196991,127687
84000,717,31038,1161210,1277590,116380
84000,574,31013,1022553,1289054,266501
84000,628,31007,1018343,1483105,464762
84000,427,30901,976873,1283664,306791
84000,337,30971,939239,1207458,268219
84000,418,30936,991767,1185009,193242
84000,204,31007,1005774,1135353,129579
84000,306,31013,1081981,1429712,347731
84000,419,30781,1213572,1237760,24188
84000,248,30932,1102287,1187589,85302
84000,133,30898,1194183,1225823,31640
84000,589,30925,1109154,1380847,271693
84000,512,30876,941608,1242617,301009
84000,138,31062,862837,1283704,420867
84000,465,30909,981999,1143769,161770
85000,382,31291,888628,1153203,264575
85000,442,31332,1037389,1226091,188702
85000,149,31392,904442,1163586,259144
85000,488,31332,1198319,1506222,307903
85000,249,31304,1106642,1133041,26399
85000,822,31287,963477,1302157,338680
85000,337,31336,1015065,1501890,486825
85000,297,31127,1187407,1246177,58770
85000,522,31295,997141,1413549,416408
85000,95,31390,1179306,1242228,62922
85000,258,31263,1367834,1909474,541640
85000,510,31171,913620,1321897,408277
85000,219,31257,1329072,1435447,106375
85000,534,31292,963517,1193445,229928
85000,853,31290,1134880,1225374,90494
85000,130,31298,1074318,1146660,72342
85000,229,31218,1016431,1181089,164658
85000,264,31011,916183,1244082,327899
85000,312,31175,981083,1121725,140642
85000,105,31246,1057991,1123996,66005
85000,335,31375,867151,1160041,292890
85000,186,31097,1014418,1342216,327798
85000,381,31290,1246122,1544876,298754
85000,161,31082,1039308,1130284,90976
85000,405,31263,996116,1086901,90785
85000,368,31222,1014692,1198808,184116
85000,460,31296,1016595,1299899,283304
85000,147,31260,927007,1245282,318275
85000,405,31281,1110973,1480645,369672
85000,356,31300,1107160,1284856,177696
85000,434,31186,1163986,1363873,199887
85000,331,31274,937959,1153105,215146
85000,284,31381,1021575,1405869,384294
85000,358,31258,933770,1279520,345750
85000,379,31187,1142954,1428488,285534
85000,397,31196,958563,1213759,255196
85000,303,31452,1075645,1107572,31927
85000,225,31309,881014,1233355,352341
85000,211,31334,1111726,1225666,113940
85000,615,31424,913772,1141488,227716
85000,205,31356,1082758,1175325,92567
85000,23,31354,964244,1231061,266817
85000,544,31406,1001964,1225694,223730
85000,175,31186,907626,1245862,338236
85000,243,31370,1214506,1272257,57751
85000,97,31199,1066854,1355897,289043
85000,326,31326,1055485,1360796,305311
85000,572,31316,901836,1077706,175870
85000,235,31169,920720,1318613,397893
85000,186,31287,873569,1250998,377429
86000,430,31841,1017710,1205870,188160
86000,459,31617,959541,1133642,174101
86000,495,31746,1144431,1237092,92661
86000,294,31606,946269,1409575,463306
86000,257,31509,918817,1188247,269430
86000,793,31741,1181507,1261399,79892
86000,178,31644,910642,1260802,350160
86000,675,31769,970634,1500803,530169
86000,425,31487,1047239,1327701,280462
86000,383,31590,990355,1087385,97030
86000,224,31715,915834,1196415,280581
86000,436,31534,951186,1307275,356089
86000,267,31706,1020097,1174718,154621
86000,347,31727,921922,1048209,126287
86000,317,31639,1261296,1284456,23160
86000,253,31749,986313,1297085,310772
86000,369,31469,921385,1353732,432347
86000,99,31634,978284,1192833,214549
86000,490,31809,1005736,1347028,341292
86000,451,31757,922524,1059273,136749
86000,639,31716,1383901,1503213,119312
86000,613,31464,1190900,1275554,84654
86000,378,31723,1283350,1349109,65759
86000,508,31609,1027313,1286521,259208
86000,224,31775,1026520,1129160,102640
86000,265,31581,988996,1121507,132511
86000,713,31539,979182,1245290,266108
86000,255,31576,969356,1171561,202205
86000,428,31772,954206,1396104,441898
86000,545,31624,981148,1177841,196693
86000,608,31547,1034679,1208447,173768
86000,388,31554,950569,1116887,166318
86000,239,31570,1132302,1300350,168048
86000,727,31768,887675,1390665,502990
86000,729,31597,1007032,1216325,209293
86000,659,31696,1104451,1245468,141017
86000,587,31697,1078569,1188166,109597
86000,737,31634,980352,1221952,241600
86000,309,31636,859640,1264026,404386
86000,237,31497,1096083,1333672,237589
86000,683,31640,879905,1138442,258537
86000,507,31575,943258,1141120,197862
86000,323,31678,907755,1307009,399254
86000,133,31552,1036731,1195789,159058
86000,262,31585,1026599,1188717,162118
86000,511,31563,1059017,1211842,152825
86000,425,31593,1115008,1495692,380684
86000,480,31737,935987,1156216,220229
86000,373,31560,1077960,1086947,8987
86000,743,31759,1000369,1342327,341958
87000,50,32041,1054012,1289956,235944
87000,315,32064,990279,1265806,275527
87000,286,31749,1090279,1209472,119193
87000,195,32016,1059029,1211003,151974
87000,94,31980,1092449,1618501,526052
87000,485,31966,1067483,1178116,110633
87000,454,31858,924114,1363624,439510
87000,146,31984,945507,1253581,308074
87000,119,32072,940504,1178918,238414
87000,612,31992,1033881,1280387,246506
87000,84,32033,997232,1316230,318998
87000,140,32021,1072755,1275401,202646
87000,314,32013,1100082,1225131,125049
87000,185,32076,944135,1426403,482268
87000,594,32015,873191,1041223,168032
87000,226,31948,1003505,1159104,155599
87000,426,31994,967898,1151665,183767
87000,503,32015,1039864,1369045,329181
87000,447,32057,887230,1172763,285533
87000,354,31989,1197244,1279922,82678
87000,466,31969,1047728,1259730,212002
87000,470,32157,1029676,1222337,192661
87000,70,31870,994324,1236058,241734
87000,136,32108,952430,1096645,144215
87000,376,32209,903213,1246513,343300
87000,487,31950,892938,1158716,265778
87000,219,32153,972067,1216267,244200
87000,129,31970,1121282,1381436,260154
87000,270,32037,1002586,1321857,319271
87000,387,31847,1051299,1329344,278045
87000,283,31839,906585,1174485,267900
87000,453,31922,949181,1400238,451057
87000,184,32102,1092341,1326425,234084
87000,470,32034,936434,1162619,226185
87000,371,32198,944915,1265930,321015
87000,161,32050,1059206,1194116,134910
87000,154,31870,947876,1117910,170034
87000,45,32017,1212678,1400742,188064
87000,314,31905,1106690,1277076,170386
87000,587,32057,1139668,1236131,96463
87000,177,31911,1057272,1340194,282922
87000,311,32088,1179546,1317074,137528
87000,24,32025,919866,1168778,248912
87000,675,31842,1078123,1185302,107179
87000,236,31915,1203651,1336510,132859
87000,292,32036,861299,1302263,440964
87000,171,32038,885562,1238797,353235
87000,202,32011,1036231,1161473,125242
87000,390,32158,1030173,1289151,258978
87000,420,31907,1072360,1120441,48081
88000,407,32369,1161464,1326517,165053
88000,159,32349,1020840,1141736,120896
88000,249,32444,992265,1170200,177935
88000,485,32451,990396,1246342,255946
88000,163,32278,1056012,1256360,200348
88000,176,32392,1010379,1230980,220601
88000,294,32345,1089205,1267974,178769
88000,201,32381,1161309,1427008,265699
88000,161,32469,1163798,1296224,132426
88000,512,32437,1099375,1446708,347333
88000,194,32316,940622,1314828,374206
88000,747,32344,1077123,1386503,309380
88000,368,32342,971171,1166351,195180
88000,137,32550,1058149,1333076,274927
88000,286,32272,1211727,1219529,7802
88000,304,32484,1128745,1202321,73576
88000,959,32473,957922,1230952,273030
88000,926,32363,990476,1205303,214827
88000,625,32284,914983,1244191,329208
88000,757,32434,1260636,1302084,41448
88000,697,32266,1136035,1211746,75711
88000,377,32211,1059096,1142196,83100
88000,281,32446,973815,1255128,281313
88000,242,32404,1117982,1207805,89823
88000,557,32467,1150216,1286274,136058
88000,422,32443,1205813,1342668,136855
88000,425,32223,1162040,1302971,140931
88000,109,32432,1162123,1323267,161144
88000,204,32184,1074860,1174272,99412
88000,262,32564,1039865,1654589,614724
88000,387,32418,997079,1180932,183853
88000,547,32321,931632,1237159,305527
88000,430,32266,985586,1257375,271789
88000,375,32438,954580,1284955,330375
88000,124,32274,961024,1202813,241789
88000,113,32156,1089634,1190363,100729
88000,354,32302,1282271,1379872,97601
88000,162,32410,1094463,1386360,291897
88000,485,32304,973287,1150244,176957
88000,202,32394,1169412,1429116,259704
88000,629,32390,987760,1563305,575545
88000,267,32166,909978,1144714,234736
88000,401,32423,932599,1196185,263586
88000,661,32377,960367,1134201,173834
88000,398,32242,900551,1247102,346551
88000,198,32319,981877,1227473,245596
88000,306,32408,1192042,1436119,244077
88000,470,32512,1194913,1284858,89945
88000,462,32399,1400135,1457117,56982
88000,144,32429,942212,1315031,372819
89000,239,32607,1018834,1260908,242074
89000,275,32564,1006161,1315179,309018
89000,350,32770,1188357,1251008,62651
89000,286,32733,952977,1221631,268654
89000,513,32876,1141511,1301232,159721
89000,561,32670,1006110,1314319,308209
89000,164,32581,1106870,1241809,134939
89000,289,32731,1122739,1219394,96655
89000,377,32820,1157444,1543367,385923
89000,262,32770,1050914,1255967,205053
89000,99,32721,930114,1187054,256940
89000,359,32625,977615,1187962,210347
89000,307,32630,1081317,1165294,83977
89000,279,32940,1070464,1327183,256719
89000,553,32527,1135099,1303663,168564
89000,54,32623,955185,1146163,190978
89000,233,32834,1029681,1406393,376712
89000,145,32637,998501,1219777,221276
89000,475,32699,1256633,1397713,141080
89000,349,32702,979364,1446287,466923
89000,24,32845,1049736,1721727,671991
89000,240,32739,1005427,1170127,164700
89000,239,32600,1079968,1276911,196943
89000,288,32770,982508,1432163,449655
89000,303,32724,1112322,1202613,90291
89000,334,32735,1139678,1292256,152578
89000,874,32764,1232224,1240266,8042
89000,63,32847,984407,1221612,237205
89000,242,32821,961816,1316181,354365
89000,415,32571,973632,1393114,419482
89000,722,32653,926261,1266961,340700
89000,293,32802,1277595,1722586,444991
89000,371,32690,1071328,1238693,167365
89000,563,32819,1154216,1334708,180492
89000,403,32786,1069180,1258776,189596
89000,130,32848,962584,1204367,241783
89000,701,32713,864536,1420295,555759
89000,397,32754,1018937,1082771,63834
89000,116,32667,975148,1672665,697517
89000,134,32768,925675,1422373,496698
89000,300,32842,990229,1288941,298712
89000,507,33023,1229164,1323313,94149
89000,310,32754,993565,1392895,399330
89000,434,32748,1090914,1182723,91809
89000,439,32603,885050,1156503,271453
89000,665,32785,1075950,1179937,103987
89000,593,32821,1193926,1303575,109649
89000,307,32716,874328,1150530,276202
89000,311,32699,1147626,1582629,435003
89000,510,32691,1048430,1362749,314319
90000,272,33216,1149384,1544732,395348
90000,307,33108,1015107,1253047,237940
90000,579,33133,969494,1275614,306120
90000,290,33178,1192017,1324646,132629
90000,539,33315,1066134,1297160,231026
90000,34,33087,984448,1159422,174974
90000,754,33212,1106946,1305107,198161
90000,473,33022,980964,1512054,531090
90000,173,32991,1000995,1234614,233619
90000,84,33131,951777,1229064,277287
90000,544,33289,927854,1278486,350632
90000,1018,33070,1120962,1499289,378327
90000,564,33031,1064513,1216854,152341
90000,56,33063,1042233,1256797,214564
90000,560,33145,1155454,1247256,91802
90000,77,33200,1495241,1546155,50914
90000,186,33047,997637,1189004,191367
90000,28,33234,1073661,1362912,289251
90000,607,33068,1012359,1442483,430124
90000,236,33063,1026851,1440685,413834
90000,155,33106,1012440,1352270,339830
90000,297,33083,1006276,1382417,376141
90000,904,33069,1069330,1414227,344897
90000,140,32921,1135424,1264420,128996
90000,332,33032,1036650,1640121,603471
90000,643,33177,910224,1193065,282841
90000,260,33114,934944,1219397,284453
90000,267,32996,1043297,1348845,305548
90000,541,33178,980997,1350214,369217
90000,105,33017,952644,1342363,389719
90000,1088,33193,1090405,1356481,266076
90000,330,33146,960696,1382509,421813
90000,334,33185,982591,1307506,324915
90000,99,33035,1162539,1407354,244815
90000,323,33099,935275,1438659,503384
90000,464,33229,950948,1478036,527088
90000,353,33047,931771,1151475,219704
90000,625,33163,973509,1278298,304789
90000,834,33132,1205005,1319914,114909
90000,107,33280,930536,1310849,380313
90000,248,33123,955506,1352676,397170
90000,179,33022,1139926,1294429,154503
90000,967,33102,893743,1219785,326042
90000,376,33189,989423,1309121,319698
90000,161,33162,1026259,1244191,217932
90000,404,33078,1210362,1416744,206382
90000,189,33123,1105155,1480098,374943
90000,539,32966,1176250,1257278,81028
90000,280,33228,1101269,1350232,248963
90000,565,32953,1185930,1268300,82370
91000,370,33621,1484632,1492689,8057
91000,239,33349,895250,1278347,383097
91000,704,33302,1142887,1220261,77374
91000,476,33628,1101415,1438412,336997
91000,395,33430,1047386,1203810,156424
91000,621,33485,1144094,1230950,86856
91000,385,33663,1031684,1444325,412641
91000,271,33357,1068091,1316793,248702
91000,780,33580,1119040,1358376,239336
91000,255,33490,928653,1524323,595670
91000,460,33542,1004648,1137335,132687
91000,25,33358,1094864,1283960,189096
91000,147,33489,988054,1456296,468242
91000,603,33388,940454,1199663,259209
91000,345,33506,1075933,1499454,423521
91000,316,33394,1088594,1162387,73793
91000,546,33465,987029,1406888,419859
91000,119,33437,1044829,1443045,398216
91000,637,33422,1085325,1207555,122230
91000,746,33477,1047117,1199005,151888
91000,448,33331,1126895,1192463,65568
91000,178,33404,1078199,1180671,102472
91000,394,33491,1093524,1249415,155891
91000,340,33421,1229138,1268836,39698
91000,216,33432,975096,1354119,379023
91000,135,33485,1016659,1135938,119279
91000,202,33475,967132,1151410,184278
91000,32,33436,1033123,1188426,155303
91000,598,33509,1093684,1428087,334403
91000,744,33552,1162563,1618844,456281
91000,237,33523,995600,1425594,429994
91000,465,33553,943977,1383957,439980
91000,365,33406,1048408,1219772,171364
91000,597,33419,1062361,1175535,113174
91000,731,33490,1028036,1268005,239969
91000,450,33726,1319110,1367840,48730
91000,86,33579,1242226,1504449,262223
91000,155,33555,1191506,1198615,7109
91000,446,33485,1011555,1278908,267353
91000,559,33460,1016799,1594498,577699
91000,260,33399,1156212,1237028,80816
91000,543,33447,919727,1337862,418135
91000,854,33248,1101145,1194891,93746
91000,184,33551,968630,1236445,267815
91000,291,33470,1127562,1291968,164406
91000,498,33403,1004372,1279085,274713
91000,601,33419,1352063,1384497,32434
91000,24,33554,977996,1329250,351254
91000,641,33607,1128528,1226720,98192
91000,619,33573,1135648,1266844,131196
92000,80,33848,1015162,1370516,355354
92000,615,33807,1301765,1499397,197632
92000,493,33912,996779,1193559,196780
92000,334,33911,1030337,1364702,334365
92000,530,33760,1213422,1242231,28809
92000,187,33908,1158058,1354033,195975
92000,375,33962,1004768,1445105,440337
92000,627,33808,1144751,1328854,184103
92000,465,33854,1048366,1341182,292816
92000,463,33838,1194349,1283700,89351
92000,231,33983,1004949,1239130,234181
92000,437,33800,1112399,1226267,113868
92000,379,33949,909658,1273225,363567
92000,621,33921,1197980,1406090,208110
92000,601,33976,1088682,1238514,149832
92000,329,33894,975672,1231120,255448
92000,202,33788,1212726,1363632,150906
92000,554,33881,1110234,1307996,197762
92000,380,33787,1021228,1521024,499796
92000,565,33878,965895,1297391,331496
92000,500,33867,1112668,1437157,324489
92000,651,33714,1157329,1314871,157542
92000,64,33952,968649,1250781,282132
92000,250,33829,951951,1211975,260024
92000,569,33835,1066841,1186438,119597
92000,114,33827,1514325,1541226,26901
92000,291,33896,985076,1310809,325733
92000,816,33980,1119090,1469014,349924
92000,452,33815,1536844,1547198,10354
92000,237,33775,1016188,1380792,364604
92000,651,33883,1156400,1298819,142419
92000,400,33749,1072667,1299732,227065
92000,30,33859,1008507,1289460,280953
92000,539,33848,1182290,1227502,45212
92000,272,33735,1009366,1220328,210962
92000,471,33864,1084803,1163694,78891
92000,534,33820,954769,1333953,379184
92000,76,33811,989996,1409585,419589
92000,27,33736,935732,1325786,390054
92000,191,33788,976241,1486948,510707
92000,150,33904,1173920,1248131,74211
92000,69,34001,1000899,1530055,529156
92000,56,33957,1509848,1525655,15807
92000,95,33860,1204305,1282715,78410
92000,553,33924,992021,1229210,237189
92000,415,33934,1206073,1547104,341031
92000,551,33943,1087662,1208372,120710
92000,418,33826,1008710,1151569,142859
92000,323,33756,988053,1263383,275330
92000,239,33880,1063690,1467829,404139
93000,228,34469,1249545,1430390,180845
93000,516,34194,1217683,1373328,155645
93000,287,34179,1096958,1522974,426016
93000,406,34257,1139877,1219680,79803
93000,446,34268,1098121,1309167,211046
93000,291,34122,931082,1193433,262351
93000,308,34225,1153969,1262048,108079
93000,497,34078,997411,1342608,345197
93000,141,34079,1063325,1297985,234660
93000,532,34225,1226389,1356668,130279
93000,385,34324,1122156,1353464,231308
93000,260,34059,1141404,1812506,671102
93000,187,34158,1004506,1310915,306409
93000,289,34163,1481593,1506703,25110
93000,461,34139,1092885,1728907,636022
93000,149,34119,1093756,1333531,239775
93000,158,34201,1017283,1470987,453704
93000,136,34202,1106786,1368663,261877
93000,350,34167,1384623,1488106,103483
93000,588,34247,992677,1312386,319709
93000,478,34262,1091748,1286243,194495
93000,191,34261,1099779,1395237,295458
93000,325,34193,1123679,1190096,66417
93000,424,34193,1016104,1468438,452334
93000,412,34322,1030386,1364313,333927
93000,369,34287,1092748,1415557,322809
93000,221,34293,1169088,1366853,197765
93000,329,34229,1453176,1539202,86026
93000,456,34184,1352972,1441500,88528
93000,195,33989,1305661,1556978,251317
93000,433,34218,1005798,1202431,196633
93000,352,34234,1056733,1363898,307165
93000,528,34274,1107768,1245200,137432
93000,212,34261,1102984,1232299,129315
93000,268,34181,1365338,1397277,31939
93000,752,34182,1281270,1370481,89211
93000,447,34237,986215,1235583,249368
93000,274,34278,1027475,1213937,186462
93000,173,34335,1055356,1227443,172087
93000,332,34223,1211541,1396257,184716
93000,322,34331,1525896,1785882,259986
93000,412,34084,1075047,1427577,352530
93000,345,34229,1179571,1387006,207435
93000,272,34390,1093517,1449507,355990
93000,235,34041,1005894,1271810,265916
93000,255,34361,1208655,1345800,137145
93000,640,34136,1182301,1353700,171399
93000,349,34170,1201401,1428562,227161
93000,428,34182,1152062,1404081,252019
93000,618,34222,1202391,1226334,23943
94000,318,34538,1136098,1361326,225228
94000,413,34624,1209163,1259464,50301
94000,489,34571,1122988,1485363,362375
94000,325,34611,1226360,1409038,182678
94000,104,34443,1157815,1248845,91030
94000,318,34744,991961,1301409,309448
94000,83,34649,923599,1264956,341357
94000,925,34487,1066508,1408140,341632
94000,161,34604,1028562,1369844,341282
94000,552,34455,1252847,1485079,232232
94000,489,34573,1002549,1280991,278442
94000,227,34583,1022144,1258739,236595
94000,181,34674,1144630,1506813,362183
94000,590,34694,1100140,1311663,211523
94000,770,34566,1013390,1218747,205357
94000,592,34499,973598,1220893,247295
94000,281,34655,1232946,1352147,119201
94000,85,34562,1200880,1354223,153343
94000,171,34529,1018578,1302645,284067
94000,374,34551,1207941,1265268,57327
94000,290,34581,1110240,1647658,537418
94000,301,34516,1157078,1239522,82444
94000,194,34574,1173821,1343757,169936
94000,332,34462,1019126,1315596,296470
94000,722,34427,1002628,1524463,521835
94000,917,34728,1292150,1322986,30836
94000,121,34481,1056960,1366017,309057
94000,370,34530,1282473,1439424,156951
94000,254,34616,999339,1285928,286589
94000,571,34370,1028717,1476070,447353
94000,518,34590,1148779,1260413,111634
94000,310,34726,1399259,1511511,112252
94000,666,34634,991300,1285796,294496
94000,358,34558,1079173,1364766,285593
94000,485,34748,959513,1303472,343959
94000,503,34555,1077151,1317625,240474
94000,405,34745,1133684,1322919,189235
94000,480,34604,1124386,1403412,279026
94000,243,34490,1159436,1363819,204383
94000,132,34584,1121298,1540249,418951
94000,366,34623,1129154,1285683,156529
94000,276,34574,1204315,1781510,577195
94000,415,34689,1275597,1402534,126937
94000,137,34720,1347593,1513953,166360
94000,774,34614,1107592,1553514,445922
94000,251,34545,960578,1481087,520509
94000,121,34481,1049318,1184846,135528
94000,767,34574,967389,1293017,325628
94000,363,34576,1126236,1343845,217609
94000,115,34554,1029958,1291736,261778
95000,337,34951,978592,1393101,414509
95000,664,35098,1133507,1258128,124621
95000,535,34901,1046102,1229996,183894
95000,473,35048,1259368,1421526,162158
95000,176,34976,1177902,1614993,437091
95000,279,34823,1202671,1429941,227270
95000,532,34929,1070029,1255477,185448
95000,209,35186,1143103,1258850,115747
95000,485,35005,1097062,1274237,177175
95000,358,34846,1006775,1442508,435733
95000,303,34891,1065365,1354296,288931
95000,390,34971,1143672,1503728,360056
95000,311,35068,1139106,1507325,368219
95000,371,34922,984106,1334510,350404
95000,373,34887,1019605,1327230,307625
95000,809,35078,1068479,1234690,166211
95000,603,35050,1079195,1641786,562591
95000,306,35150,1194971,1394712,199741
95000,329,34975,1277419,1404549,127130
95000,190,34912,958037,1365541,407504
95000,1095,34909,1123886,1502870,378984
95000,419,34992,1047048,1326554,279506
95000,443,35006,1182316,1490457,308141
95000,429,34887,1028979,1179445,150466
95000,519,34962,1187575,1486506,298931
95000,537,34933,1104546,1476005,371459
95000,326,34954,1018720,1275651,256931
95000,594,34953,1294770,1380894,86124
95000,272,34829,1003098,1372959,369861
95000,459,35117,987564,1298152,310588
95000,420,34915,1106562,1307274,200712
95000,489,34922,1099073,1366934,267861
95000,580,34895,1323673,1419161,95488
95000,306,34925,1170591,1332919,162328
95000,221,35014,1144589,1318141,173552
95000,377,34962,1464832,1505840,41008
95000,239,34944,1014365,1362313,347948
95000,140,34953,1055927,1285832,229905
95000,328,34955,1422236,1637077,214841
95000,427,34801,1081383,1336398,255015
95000,350,35051,1000709,1346913,346204
95000,228,35131,956992,1684687,727695
95000,429,34879,1223579,1360154,136575
95000,370,35069,1368286,1383151,14865
95000,486,34913,1145060,1290153,145093
95000,433,34777,1134564,1444924,310360
95000,438,35005,1340544,1526875,186331
95000,418,34820,1024345,1401378,377033
95000,309,34942,1073301,1424037,350736
95000,443,34987,1082398,1359052,276654
96000,269,35296,1189353,1535076,345723
96000,791,35259,1052147,1398373,346226
96000,355,35280,1368577,1392216,23639
96000,202,35215,958939,1442125,483186
96000,477,35384,1244587,1453833,209246
96000,238,35363,1110569,1421689,311120
96000,190,35413,1440836,1511310,70474
96000,518,35354,1152740,1455772,303032
96000,520,35381,1151977,1430622,278645
96000,276,35291,1230330,1406344,176014
96000,300,35345,1295611,1419544,123933
96000,480,35287,1262832,1411905,149073
96000,206,35239,995417,1283422,288005
96000,388,35216,1106505,1300360,193855
96000,263,35530,1236351,1291291,54940
96000,351,35382,1273586,1326555,52969
96000,366,35419,1314865,1477287,162422
96000,213,35259,1318136,1451824,133688
96000,213,35337,1110905,1512659,401754
96000,452,35190,1184295,1386720,202425
96000,559,35193,1049616,1433188,383572
96000,334,35319,1077191,1568534,491343
96000,422,35389,1101579,1253209,151630
96000,572,35309,1093714,1432294,338580
96000,441,35424,1023469,1216938,193469
96000,211,35365,1001545,1326038,324493
96000,285,35353,1170633,1391826,221193
96000,61,35256,993209,1228987,235778
96000,493,35492,1204604,1351679,147075
96000,616,35187,1033279,1507395,474116
96000,177,35086,1102238,1327191,224953
96000,664,35146,1118198,1274085,155887
96000,230,35138,1213188,1395261,182073
96000,295,35334,1037344,1309570,272226
96000,110,35319,1141674,1319408,177734
96000,427,35189,1493633,1587992,94359
96000,668,35267,1199064,1315452,116388
96000,549,35194,1251926,1530292,278366
96000,609,35366,1220687,1423913,203226
96000,648,35303,1016157,1612319,596162
96000,529,35398,1083156,1821681,738525
96000,321,35353,1506196,1592816,86620
96000,310,35298,921908,1373352,451444
96000,349,35485,1109667,1330505,220838
96000,79,35379,1138049,1280131,142082
96000,629,35451,1491500,1552960,61460
96000,177,35292,1097343,1240291,142948
96000,420,35255,1144424,1570649,426225
96000,452,35262,1141126,1296734,155608
96000,477,35301,1112690,1395625,282935
97000,479,35829,1110790,1322470,211680
97000,545,35831,1254471,1481540,227069
97000,128,35511,1131444,1436563,305119
97000,146,35682,1182399,1686524,504125
97000,275,35754,1059079,1432272,373193
97000,460,35507,1164650,1726064,561414
97000,215,35606,1099871,1420089,320218
97000,660,35694,1125700,1666988,541288
97000,210,35683,1157976,1467508,309532
97000,214,35679,1067459,1350050,282591
97000,390,35735,1106964,1291274,184310
97000,508,35633,1193144,1328440,135296
97000,310,35631,1096992,1367926,270934
97000,352,35670,1002595,1273395,270800
97000,754,35643,1105646,1304300,198654
97000,826,35631,1113057,1222121,109064
97000,908,35746,1207126,1577586,370460
97000,571,35584,1164881,1512100,347219
97000,638,35670,1020759,1363930,343171
97000,702,35774,1019529,1398112,378583
97000,362,35587,1045662,1312776,267114
97000,343,35595,1477445,1762553,285108
97000,407,35680,1263983,1506302,242319
97000,297,35669,1173333,1453978,280645
97000,330,35553,1132917,1371315,238398
97000,273,35773,1143660,1436667,293007
97000,369,35625,1403549,1523403,119854
97000,439,35829,1164134,1368110,203976
97000,484,35507,1124675,1618377,493702
97000,770,35572,1123073,1364159,241086
97000,469,35786,1197601,1540718,343117
97000,357,35500,1147662,1635805,488143
97000,284,35541,1326434,1472663,146229
97000,422,35718,1134755,1441299,306544
97000,1403,35679,989241,1224659,235418
97000,158,35663,969325,1317346,348021
97000,168,35804,1062427,1463969,401542
97000,568,35831,1111248,1377258,266010
97000,1243,35524,1054663,1299175,244512
97000,703,35572,1190933,1413106,222173
97000,179,35636,1196538,1313556,117018
97000,53,35766,1345264,1412670,67406
97000,173,35653,1143252,1591901,448649
97000,365,35679,1118614,1218594,99980
97000,397,35439,1073036,1253740,180704
97000,420,35745,1163724,1485498,321774
97000,197,35708,1448128,1614201,166073
97000,394,35713,1085949,1367069,281120
97000,658,35561,1354164,1497246,143082
97000,493,35699,1132207,1471981,339774
98000,67,36023,1141660,1490440,348780
98000,588,36047,1198925,1496124,297199
98000,312,36132,1096373,1320656,224283
98000,136,36137,1015300,1365973,350673
98000,363,36100,1167839,1460361,292522
98000,156,36169,1028430,1281173,252743
98000,188,35986,1105032,1412886,307854
98000,348,36100,1109711,1629807,520096
98000,414,36176,1247281,1455266,207985
98000,431,36085,1330823,1575537,244714
98000,448,35995,1161145,1562859,401714
98000,424,36071,1508547,1730357,221810
98000,308,35934,1298386,1548714,250328
98000,330,35939,1106648,1255747,149099
98000,523,35976,1308015,1327551,19536
98000,329,35994,1103629,1400644,297015
98000,685,36062,1033383,1301062,267679
98000,214,36016,1241425,1416172,174747
98000,229,36012,1220731,1620992,400261
98000,128,36048,1143053,1293413,150360
98000,224,35975,1343759,1519216,175457
98000,439,36179,1449655,1672726,223071
98000,291,36005,1444697,1528036,83339
98000,438,36129,1066362,1382825,316463
98000,34,36250,1421841,1445926,24085
98000,231,35913,1545910,1609337,63427
98000,146,36049,990026,1271960,281934
98000,386,36061,1158296,1598568,440272
98000,468,36056,1361123,1361205,82
98000,583,35965,1039354,1433591,394237
98000,120,35968,1088695,1495877,407182
98000,694,35959,1236006,1383276,147270
98000,514,36226,1045037,1361896,316859
98000,580,36211,1126300,1353150,226850
98000,540,36032,1064757,1327793,263036
98000,456,36124,1162652,1563774,401122
98000,401,36038,1085663,1502504,416841
98000,383,36048,1260246,1326811,66565
98000,246,35897,1196796,1416006,219210
98000,336,36098,1081906,1642280,560374
98000,363,35987,1054134,1545033,490899
98000,475,36072,1343153,1379587,36434
98000,312,36151,1237476,1409518,172042
98000,306,35974,1388822,1559665,170843
98000,430,35850,1034491,1329092,294601
98000,619,35855,1308135,1597032,288897
98000,489,35889,1162887,1330965,168078
98000,327,36035,1309237,1503452,194215
98000,323,36012,1026058,1301214,275156
98000,524,36148,1016475,1479001,462526
99000,506,36459,1158661,1317434,158773
99000,201,36425,1475004,1667393,192389
99000,275,36499,1165407,1495337,329930
99000,703,36253,1669168,1690241,21073
99000,321,36379,1377951,1508961,131010
99000,510,36505,1061489,1283693,222204
99000,223,36372,1279983,1445916,165933
99000,477,36291,1147655,1334999,187344
99000,111,36534,1309370,1531130,221760
99000,617,36415,1091733,1378236,286503
99000,388,36568,1236522,1636794,400272
99000,483,36537,1160710,1230351,69641
99000,233,36495,1289402,1467718,178316
99000,433,36566,1500714,1814191,313477
99000,781,36394,1249297,1430940,181643
99000,481,36358,1480674,1558302,77628
99000,391,36234,1018484,1667546,649062
99000,422,36312,1025553,1292622,267069
99000,437,36350,1412151,1483185,71034
99000,429,36333,1387970,1605171,217201
99000,114,36465,1355903,1600251,244348
99000,566,36442,1313552,1732286,418734
99000,844,36528,1002630,1434037,431407
99000,420,36482,1137148,1476662,339514
99000,240,36319,1236716,1347645,110929
99000,705,36600,1535711,1783340,247629
99000,745,36436,1262251,1571619,309368
99000,218,36362,1257439,1669335,411896
99000,174,36477,1591770,1920910,329140
99000,462,36536,1233986,1776155,542169
99000,379,36472,1091614,1531907,440293
99000,517,36498,1163433,1447476,284043
99000,271,36350,1221547,1483785,262238
99000,381,36402,1310987,1509253,198266
99000,319,36428,1131560,1492288,360728
99000,264,36473,1129307,1321330,192023
99000,677,36595,1025008,1334311,309303
99000,527,36378,1256222,1450054,193832
99000,658,36333,1139859,1450196,310337
99000,352,36499,1174598,1283757,109159
99000,397,36381,1224344,1497039,272695
99000,177,36378,1392735,1565298,172563
99000,482,36175,1077962,1263340,185378
99000,292,36257,1162618,1403748,241130
99000,327,36442,1314665,1345237,30572
99000,394,36456,1067147,1404349,337202
99000,289,36328,1198332,1748453,550121
99000,672,36397,1296321,1566408,270087
99000,274,36433,1126079,1482491,356412
99000,466,36483,1107836,1701177,593341
100000,287,36861,1307034,1793039,486005
100000,532,36818,1104842,1388803,283961
100000,151,36637,1271072,1433856,162784
100000,286,36885,1402106,1567861,165755
100000,394,36831,1167817,1420228,252411
100000,333,36744,1107955,1709422,601467
100000,270,36818,1108468,1347231,238763
100000,482,36635,1265161,1505560,240399
100000,419,36812,1199474,1561566,362092
100000,321,36856,1219721,1366552,146831
100000,279,36780,1457847,1938826,480979
100000,379,36601,1224763,1968877,744114
100000,258,36789,1373008,1433839,60831
100000,475,36602,1132845,1691612,558767
100000,564,36709,1337815,1429178,91363
100000,712,36921,1002021,1320413,318392
100000,577,36739,1208226,1697068,488842
100000,719,36921,1185198,1355480,170282
100000,138,36751,1145302,1473723,328421
100000,237,36782,1234951,1312838,77887
100000,377,37037,1128532,1368999,240467
100000,338,36699,1405074,1476556,71482
100000,150,36840,1232139,1504102,271963
100000,159,36752,1138729,1347248,208519
100000,226,36810,1130542,1675459,544917
100000,471,36821,1106444,1482997,376553
100000,748,36661,1136280,1505537,369257
100000,130,36951,1313481,1520521,207040
100000,326,36785,1190494,1559785,369291
100000,522,36780,1195078,1371648,176570
100000,358,36687,1236100,1422559,186459
100000,866,36780,1042818,1518440,475622
100000,258,36912,1473217,1481575,8358
100000,397,36728,1172680,1427535,254855
100000,339,36876,1165506,1238530,73024
100000,232,36774,1231319,1355291,123972
100000,658,36808,1234104,1380876,146772
100000,595,36615,1079148,1423405,344257
100000,428,36969,1111525,1296405,184880
100000,537,36691,1193829,1488962,295133
100000,430,36698,1151766,1527211,375445
100000,233,36628,1223531,1498646,275115
100000,282,36619,1195081,1467043,271962
100000,396,36825,1256347,1412748,156401
100000,139,36646,1163250,1691665,528415
100000,465,36847,1087846,1567811,479965
100000,288,36732,1195989,1383600,187611
100000,288,36797,1278937,1375500,96563
100000,214,36627,1217403,1352656,135253
100000,622,36774,1308666,1552028,243362
